Year,Team,Gold,Silver,Bronze,Total
1896,Australia,2,0,0,2
1896,Australia/Great Britain,0,0,1,1
1896,Austria,2,1,2,5
1896,Denmark,1,2,3,6
1896,Ethnikos Gymnastikos Syllogos,0,0,1,1
1896,France,5,4,2,11
1896,Germany,6,5,2,13
1896,Great Britain,2,3,2,7
1896,Great Britain/Germany,1,0,0,1
1896,Greece,10,16,16,42
1896,Greece-1,0,1,0,1
1896,Greece-2,0,0,0,0
1896,Greece-3,0,0,0,0
1896,Hungary,2,1,3,6
1896,Italy,0,0,0,0
1896,Sweden,0,0,0,0
1896,Switzerland,1,2,0,3
1896,United States,11,6,2,19
1900,A North American Team,0,0,1,1
1900,Alcyon-6,0,0,0,0
1900,Alcyon-7,0,0,0,0
1900,Amateur Athletic Association,1,0,0,1
1900,Amulet-3,0,0,0,0
1900,Amulet-7,0,0,0,0
1900,Argentina,0,0,0,0
1900,Ariette-10,0,0,0,0
1900,Ariette-8,0,0,0,0
1900,Aschenbrodel,1,1,0,2
1900,Australia,2,0,3,5
1900,Austria,0,3,3,6
1900,Austria-1,0,0,0,0
1900,"BLO Polo Club, Rugby",0,1,0,1
1900,Baby-1,1,0,1,2
1900,Baby-9,0,0,0,0
1900,"Bagatelle Polo Club, Paris",0,0,1,1
1900,Belgium,5,5,4,14
1900,Belgium-1,1,0,0,1
1900,Belgium-2,0,0,0,0
1900,Bohemia,0,1,1,2
1900,Bohemia/Great Britain,0,0,1,1
1900,Bona Fide,1,0,0,1
1900,Brazil,0,0,0,0
1900,Brussels Swimming and Water Polo Club,0,1,0,1
1900,Brynhild-2,0,1,0,1
1900,C.V.A.-14,0,0,0,0
1900,C.V.A.-7,0,0,0,0
1900,Canada,1,0,1,2
1900,Carabinier-15,1,0,0,1
1900,Carabinier-5,0,0,0,0
1900,Cercle Nautique de Reims-4,0,0,0,0
1900,Cercle de l'Aviron Roubaix-4,1,0,0,1
1900,Cicely-1,1,0,0,1
1900,Cinara-13,0,0,0,0
1900,Club Nautique de Dieppe-5,0,0,0,0
1900,Club Nautique de Franais-1,0,0,0,0
1900,Club Nautique de Lyon-2,0,1,0,1
1900,Colette-10,0,0,0,0
1900,Colette-12,0,0,0,0
1900,Compigne Polo Club,0,0,0,0
1900,Crabe I-11,0,0,0,0
1900,Crabe I-2,0,0,0,0
1900,Crabe I-3,0,0,0,0
1900,Crabe II-1,0,1,0,1
1900,Crabe II-12,0,0,0,0
1900,Crabe II-4,0,0,1,1
1900,Crocodile-11,0,0,0,0
1900,Crocodile-13,0,0,0,0
1900,Cuba,1,1,0,2
1900,Demi-Mondaine-15,0,0,0,0
1900,Demi-Mondaine-17,0,0,0,0
1900,Denmark,1,3,2,6
1900,Denmark/Sweden,1,0,0,1
1900,Deutscher Schwimm Verband Berlin,1,0,0,1
1900,Devon and Somerset Wanderers,1,0,0,1
1900,Dick-8,0,0,0,0
1900,Ducky-16,0,0,0,0
1900,Ducky-4,0,0,0,0
1900,Esterel-1,1,0,0,1
1900,Fantlet-2,0,0,0,0
1900,Fantlet-7,1,0,0,1
1900,Favorite Hammonia-3,0,0,1,1
1900,Favorite-1,0,1,0,1
1900,Favorite-17,0,0,0,0
1900,Femur-1,1,0,0,1
1900,Femur-18,0,0,0,0
1900,Formosa,0,0,1,1
1900,Foxhunters Hurlingham,1,0,0,1
1900,France,21,23,22,66
1900,France-1,0,1,2,3
1900,France-2,0,0,0,0
1900,France-3,0,0,0,0
1900,France-4,0,0,0,0
1900,France/Great Britain,0,1,0,1
1900,Frankfurt Club,0,1,0,1
1900,Freia-19,0,0,0,0
1900,Freia-5,0,0,0,0
1900,Frimousse,0,0,1,1
1900,Galopin-20,0,0,0,0
1900,Galopin-9,0,0,0,0
1900,"Germania Ruder Club, Hamburg",0,0,0,0
1900,"Germania Ruder Club, Hamburg-2",1,0,0,1
1900,Germany,1,1,0,2
1900,Germany-1,0,0,0,0
1900,Giselle-6,0,0,0,0
1900,Gitana-2,0,1,1,2
1900,Gitana-21,0,0,0,0
1900,Great Britain,8,6,6,20
1900,Great Britain-1,1,0,0,1
1900,Great Britain-2,0,0,1,1
1900,Greece,0,0,0,0
1900,Gwendoline-2,0,0,1,1
1900,Gwendoline-22,0,0,0,0
1900,Gyp-23,0,0,0,0
1900,Gyp-6,0,0,0,0
1900,Haiti,0,0,0,0
1900,Hb-20,0,0,0,0
1900,Hb-24,0,0,0,0
1900,Hungary,1,2,2,5
1900,India,0,2,0,2
1900,Iran,0,0,0,0
1900,Italy,3,2,0,5
1900,Jeanette-25,0,0,0,0
1900,Jeannette-18,0,0,0,0
1900,Laurea-1,0,0,1,1
1900,Lerina,1,1,0,2
1900,Libellule de Paris,0,0,1,1
1900,Libellule de Paris-3,0,0,0,0
1900,Ludwigshafener Ruder Verein-1,0,0,1,1
1900,Luxembourg,1,0,0,1
1900,Mamie-4,0,0,0,0
1900,Mamie-6,0,0,0,0
1900,Marsouin-26,0,0,0,0
1900,Marsouin-8,0,0,0,0
1900,Martha-1,0,1,1,2
1900,Martha-27,0,0,0,0
1900,Mascaret-28,0,0,0,0
1900,Mascaret-4,0,0,0,0
1900,Mascotte,0,1,0,1
1900,Mignon-29,0,0,0,0
1900,Mignon-3,0,0,1,1
1900,Minerva Amsterdam,1,1,1,3
1900,Moseley Wanderers,0,1,0,1
1900,Nan-2,0,0,0,0
1900,Netherlands,0,0,2,2
1900,Nina Claire-2,0,0,1,1
1900,Nina Claire-30,0,0,0,0
1900,Norway,0,2,3,5
1900,Olle,1,0,0,1
1900,"Osborne Swimming Club, Manchester",1,0,0,1
1900,Peru,0,0,0,0
1900,Pettit-Poucet-6,0,0,0,0
1900,Pierre et Jean-3,0,0,0,0
1900,Pierre et Jean-4,0,0,0,0
1900,Pirouette-31,0,0,0,0
1900,Pirouette-5,0,0,0,0
1900,Plume-Patte-5,0,0,0,0
1900,Plume-patte-32,0,0,0,0
1900,Pupilles de Neptune de Lille #1-3,0,0,0,0
1900,Pupilles de Neptune de Lille #2-1,0,0,1,1
1900,Pupilles de Neptune de Lille-1,0,0,1,1
1900,Quand-Mme-2,0,2,0,2
1900,Quand-Mme-33,0,0,0,0
1900,Racing Club de France,0,2,0,2
1900,Ral-Club Barcelona,0,0,0,0
1900,Romania,0,0,0,0
1900,Rowing Club Castillon-3,0,0,1,1
1900,Royal Club Nautique de Gand,0,1,0,1
1900,Rozenn-3,0,0,0,0
1900,Russia,0,0,0,0
1900,Russia-1,0,0,0,0
1900,Sarcelle-3,0,0,1,1
1900,Sarcelle-35,0,0,0,0
1900,Scamasaxe-2,0,0,1,1
1900,Scamasaxe-3,0,1,0,1
1900,Scamasaxe-34,0,0,0,0
1900,Scotia,2,0,0,2
1900,Sidi Fekkar-36,0,0,0,0
1900,Sidi-Fekkar-14,0,0,0,0
1900,Singy-37,0,0,0,0
1900,Singy-7,0,0,0,0
1900,Societ Nautique de la Marne,0,0,0,0
1900,Societ Nautique de la Marne-1,0,1,0,1
1900,Societ Nautique de la Marne-3,0,0,0,0
1900,Souriceau-38,0,0,0,0
1900,Souriceau-4,0,0,0,0
1900,Souvenance,0,0,0,0
1900,Spain,1,0,0,1
1900,Spain-1,0,0,0,0
1900,Stade Franais AC-2,0,0,0,0
1900,Suzon IV-39,0,0,0,0
1900,Suzon IV-5,0,0,0,0
1900,Sweden,0,0,1,1
1900,Switzerland,5,1,1,7
1900,Tornade-16,0,0,0,0
1900,Tournade-40,0,0,0,0
1900,Tritons Lillois-2,0,1,0,1
1900,Turquoise-1,0,0,1,1
1900,Turquoise-3,0,0,0,0
1900,USFSA,0,1,0,1
1900,Union des Socits Franais de Sports Athletiques,1,1,0,2
1900,United States,18,14,13,45
1900,United States/France,0,1,0,1
1900,United States/Great Britain,0,0,1,1
1900,Univ. of Brussels,0,0,1,1
1900,Upton Park FC,1,0,0,1
1900,Verveine-19,0,0,0,0
1900,Verveine-41,0,0,0,0
1900,Vesper Boat Club,1,0,0,1
1904,Atalanta Boat Club-1,1,0,0,1
1904,Atalanta Boat Club-2,0,1,0,1
1904,Australia,0,3,1,4
1904,Austria,1,1,1,3
1904,Boer Team,0,0,0,0
1904,Boston Archers,0,0,1,1
1904,Canada,2,0,0,2
1904,"Central Turnverein, Chicago",0,0,1,1
1904,Century Boat Club-1,1,0,0,1
1904,Chicago Archers,0,0,0,0
1904,Chicago Athletic Association,0,1,0,1
1904,Chicago Athletic Association-2,0,2,0,2
1904,Christian Brothers' College-1,0,1,0,1
1904,Cincinnati Archers,1,1,0,2
1904,"Concordia Turnverein, St Louis",0,0,0,0
1904,Cuba,4,0,0,4
1904,"Davenport Turngemeinde, Davenport",0,0,0,0
1904,France,0,1,0,1
1904,Galt Football Club,1,0,0,1
1904,Germany,4,5,6,15
1904,Germany/United States,0,0,0,0
1904,Great Britain,1,1,0,2
1904,Greece,1,0,1,2
1904,Hungary,2,1,1,4
1904,Independent Rowing Club-3,0,0,1,1
1904,Italy,0,0,0,0
1904,"La Salle Turnverein, Chicago",0,0,0,0
1904,Milwaukee Athletic Club-1,1,0,0,1
1904,"Milwaukee Turnverein, Milwaukee",0,0,0,0
1904,Missouri Athletic Club-3,0,0,2,2
1904,Mohawk Indians-2,0,0,1,1
1904,Mound City Rowing Club-2,0,1,0,1
1904,New York Athletic Club,1,0,0,1
1904,New York Athletic Club #1-1,1,0,0,1
1904,New York Athletic Club #2-4,0,0,0,0
1904,New York Athletic Club-1,1,0,0,1
1904,New York Athletic Club-4,0,0,0,0
1904,"New York Turnverein, New York",0,1,0,1
1904,Newfoundland,0,0,0,0
1904,Norway,2,0,0,2
1904,"Norwegier Turnverein, Brooklyn",0,0,0,0
1904,Pan-Hellenic Athletic Club,0,0,0,0
1904,"Passaic Turnverein, Passaic",0,0,0,0
1904,"Philadelphia Turngemeinde, Philadelphia",1,0,0,1
1904,Potomac Archers,1,0,0,1
1904,Ravenswood Boat Club-2,0,1,0,1
1904,Seawanhaka Boat Club-1,1,0,0,1
1904,"Socialer Turnverein, Detroit",0,0,0,0
1904,South Africa,0,0,0,0
1904,"South St Louis Turnverein, St Louis",0,0,0,0
1904,St. Louis Amateur Athletic Association,0,1,0,1
1904,St. Louis Southwest Turnverein #1-2,0,1,0,1
1904,St. Louis Southwest Turnverein #2-3,0,0,1,1
1904,St. Rose-2,0,0,1,1
1904,Switzerland,1,0,2,3
1904,Toronto Argonauts,0,1,0,1
1904,Trans-Mississippi Golf Association-2,0,1,0,1
1904,"Turnverein Vorwrts, Chicago",0,0,0,0
1904,"Turnverein Vorwrts, Cleveland",0,0,0,0
1904,United States,63,66,64,193
1904,United States Golf Association-3,0,0,1,1
1904,United States-1,1,0,0,1
1904,United States-10,0,0,0,0
1904,United States-11,0,0,0,0
1904,United States-12,0,0,0,0
1904,United States-13,0,0,0,0
1904,United States-14,0,0,0,0
1904,United States-2,0,1,0,1
1904,United States-3,0,0,1,1
1904,United States-4,0,0,1,1
1904,United States-5,0,0,0,0
1904,United States-6,0,0,0,0
1904,United States-7,0,0,0,0
1904,United States-8,0,0,0,0
1904,United States-9,0,0,0,0
1904,Vesper Boat Club,1,0,0,1
1904,Western Golf Association-1,1,0,0,1
1904,Western Rowing Club-3,0,0,2,2
1904,Winnipeg Shamrocks-1,1,0,0,1
1906,Athens-2,0,0,0,0
1906,Australia,0,0,3,3
1906,Austria,3,3,3,9
1906,Barion/Bari-2,0,1,0,1
1906,Belgium,2,1,3,6
1906,Bohemia,0,0,2,2
1906,Bucintoro Venezia,2,0,0,2
1906,Bucintoro Venezia-1,1,0,0,1
1906,Canada,1,1,0,2
1906,Crete,0,0,0,0
1906,Dansk Idrts Forbund,0,0,0,0
1906,Denmark,3,2,1,6
1906,Egypt,0,0,0,0
1906,Finland,2,1,1,4
1906,France,15,8,13,36
1906,Germany,4,6,4,14
1906,Great Britain,8,11,5,24
1906,Greece,7,8,10,25
1906,Greece-1,0,2,0,2
1906,Greece-2,0,0,1,1
1906,Greece-3,0,0,0,0
1906,Greece-4,0,0,0,0
1906,Hungary,2,5,3,10
1906,Italy,3,5,1,9
1906,"Large boat, Central Naval Prep School ""Poros""-1",1,0,0,1
1906,"Lemzos Thorichton ""Psara""-3",0,0,0,0
1906,"Lemzos Thorichton ""Spetsai""-4",0,0,0,0
1906,"Life boat naval ship ""Spetsai""-1",0,1,0,1
1906,"Marinai della nave da guerra ""Varese""",1,0,1,2
1906,Nautikos Omilos-3,0,0,0,0
1906,Netherlands,0,1,2,3
1906,Norway,1,1,0,2
1906,Omas Helliniki P. S.,0,1,0,1
1906,Omilos Ereton Peiraios-2,0,0,0,0
1906,Omilos Ereton Smyrnis,0,0,0,0
1906,Panhellenios Gymnastikos Syllogos-1,0,0,0,0
1906,Peiraikos Syndesmos-2,0,0,0,0
1906,"Phalainis ton Thorichtou ""Hydra""-2",0,1,1,2
1906,"Phalainis ton Thorichtou ""Psara""-3",0,0,0,0
1906,Pistoja/Firenze,0,0,1,1
1906,Roma,0,0,0,0
1906,Royal Club Nautique de Gand,0,1,0,1
1906,Smyrna,0,1,0,1
1906,Socit Nautique de Bayonne-1,0,0,1,1
1906,Socit Nautique de Bayonne-2,0,0,1,1
1906,Socit Nautique de la Basse Seine-1,0,1,1,2
1906,Socit Nautique de la Basse Seine-2,0,0,0,0
1906,Sweden,2,5,7,14
1906,Switzerland,4,3,1,8
1906,Thessalonki-1,0,0,1,1
1906,Turkey,0,0,0,0
1906,United States,12,5,6,23
1908,Amstel Amsterdam,0,0,1,1
1908,Argentina,0,0,0,0
1908,Argonaut Rowing Club,0,0,2,2
1908,Australasia,1,2,2,5
1908,Austria,0,0,1,1
1908,Belgium,1,3,2,6
1908,Berliner Ruderclub,0,0,1,1
1908,Bohemia,0,0,2,2
1908,Cambridge University Boat Club-2,0,0,1,1
1908,Camille,1,0,0,1
1908,Canada,3,3,7,13
1908,Cobweb-1,1,0,0,1
1908,Cornwall,0,1,0,1
1908,Denmark,0,2,3,5
1908,Dormy-1,1,0,0,1
1908,Dylan-2,0,0,0,0
1908,England-1,1,0,0,1
1908,Finland,1,1,3,5
1908,Fram,0,0,0,0
1908,France,4,5,8,17
1908,France-1,0,0,0,0
1908,France-2,0,0,0,0
1908,Freja,0,0,0,0
1908,Germany,3,5,4,12
1908,Germany-1,0,0,0,0
1908,Germany-2,0,0,0,0
1908,Great Britain,40,39,29,108
1908,Great Britain-1,4,1,0,5
1908,Great Britain-2,0,3,2,5
1908,Great Britain-3,0,0,2,2
1908,Great Britain-4,0,0,0,0
1908,Greece,0,3,1,4
1908,Guyoni,0,0,1,1
1908,Gyrinus-1,2,0,0,2
1908,Hera-1,1,0,0,1
1908,Heroine,1,0,0,1
1908,Hungary,3,4,2,9
1908,Hurlingham-2,0,1,0,1
1908,Iceland,0,0,0,0
1908,Ireland-2,0,1,0,1
1908,Ireland-3,0,1,0,1
1908,Italy,2,2,0,4
1908,K Division Metropolitan Police Team-3,0,0,1,1
1908,Leander Club #1-1,1,0,0,1
1908,Leander Club #2-2,0,1,0,1
1908,Leander Club-1,1,0,0,1
1908,Leander Club-2,0,1,0,1
1908,Liverpool Police Team-2,0,1,0,1
1908,London City Police-1,1,0,0,1
1908,Magdalen College Boat Club-1,1,0,0,1
1908,Mouchette-2,0,1,0,1
1908,Netherlands,0,0,1,1
1908,Norway,2,3,3,8
1908,Norwegian Rowing Association,0,0,0,0
1908,Pannonia RC/National RC,0,0,0,0
1908,Quicksilver-2,0,0,0,0
1908,Roehampton-1,1,0,0,1
1908,Royal Club Nautique de Gand,0,1,0,1
1908,Russia,1,2,0,3
1908,Saga-2,0,0,0,0
1908,Scotland-3,0,0,1,1
1908,Sea Dog-2,0,0,0,0
1908,Sibindi-2,0,0,0,0
1908,Sorais-2,0,0,1,1
1908,South Africa,1,1,0,2
1908,Sweden,8,5,11,24
1908,Switzerland,0,0,0,0
1908,Toronto Argonauts,0,0,1,1
1908,United States,22,12,12,46
1908,Vinga-1,0,1,0,1
1908,Wales-4,0,0,1,1
1908,Wolseley-Siddeley-1,0,0,0,0
1908,Zut,0,1,0,1
1912,Australasia,2,2,3,7
1912,Austria,0,2,2,4
1912,Belgium,2,1,3,6
1912,Berliner Ruderclub Sport-Borussia-1,0,0,0,0
1912,Berliner Ruderverein von 1876-2,0,0,1,1
1912,Bohemia,0,0,0,0
1912,Bohemia-1,0,0,0,0
1912,Bohemia-2,0,0,0,0
1912,Bohemia-3,0,0,0,0
1912,Bylina-2,0,0,0,0
1912,Canada,3,2,3,8
1912,Chile,0,0,0,0
1912,Denmark,0,5,4,9
1912,Denmark-1,0,0,0,0
1912,Denmark-2,0,0,0,0
1912,Denmark-3,0,0,0,0
1912,Denmark-4,0,0,0,0
1912,England,0,1,0,1
1912,England-1,0,1,0,1
1912,Erna Signe,0,1,0,1
1912,Finland,9,7,7,23
1912,Finn II,0,0,0,0
1912,France,6,5,3,14
1912,Gallia II,0,0,1,1
1912,Germany,5,13,6,24
1912,Germany-1,0,0,0,0
1912,Germany-2,0,0,0,0
1912,Great Britain,8,10,15,33
1912,Great Britain-1,0,1,0,1
1912,Great Britain-2,1,0,1,2
1912,Great Britain-3,0,0,0,0
1912,Great Britain-4,0,0,0,0
1912,Greece,1,0,1,2
1912,Gteborgs Roddfrening-2,0,0,0,0
1912,Gteborgs Roddklubb-1,0,0,0,0
1912,Heatherbell,0,0,1,1
1912,Helsingfors R. K.,0,0,0,0
1912,Hungaria Evezos Egylet,0,0,0,0
1912,Hungary,3,2,3,8
1912,Hungary-2,0,0,0,0
1912,Hungary-3,0,0,0,0
1912,Iceland,0,0,0,0
1912,Ireland,0,0,0,0
1912,Ireland-3,0,0,0,0
1912,Italy,5,1,2,8
1912,Japan,0,0,0,0
1912,K.S.S.S. 1912-2,0,0,0,0
1912,Kerstin-1,0,0,1,1
1912,Kitty-1,1,0,0,1
1912,Kristiania Roklub,0,0,0,0
1912,Kristiania Roklub-1,0,0,1,1
1912,Leander Club-1,1,0,0,1
1912,Lucky Girl-1,0,0,1,1
1912,Ludwigshafener Ruderverein,1,0,0,1
1912,Luxembourg,0,0,0,0
1912,Mac Miche,1,0,0,1
1912,Magda IX,1,0,0,1
1912,Marga-2,0,0,0,0
1912,Netherlands,0,0,3,3
1912,"New College, Oxford-2",0,1,0,1
1912,Nina,0,1,0,1
1912,Norman-1,0,0,0,0
1912,Norway,2,1,3,6
1912,Norway-1,0,0,0,0
1912,Norway-2,0,0,0,0
1912,Norway-3,0,0,0,0
1912,Nurdug II,0,1,0,1
1912,Nykjbings paa Falster,1,0,0,1
1912,Ormsund Roklub-2,0,0,1,1
1912,Poland,0,0,0,0
1912,Polyteknisk Roklub-1,0,0,1,1
1912,Portugal,0,0,0,0
1912,"R.-V. Germania, Leitmeritz",0,0,0,0
1912,Roddklubben af 1912-1,0,1,0,1
1912,Roddklubben af 1912-2,0,0,0,0
1912,Roklubb Kbnhavn-2,0,0,0,0
1912,Royal Club Nautique de Gand,0,0,0,0
1912,Russia,0,2,2,4
1912,Sans Atout-1,0,1,0,1
1912,Sass-2,0,0,0,0
1912,Scotland,0,0,0,0
1912,Scotland-2,0,0,0,0
1912,Serbia,0,0,0,0
1912,Socit Nautique de Bayonne,0,0,0,0
1912,Sonja II,0,0,0,0
1912,South Africa,4,2,0,6
1912,Studenternes Roklub-2,0,0,0,0
1912,Sweden,23,19,15,57
1912,Sweden-1,0,1,0,1
1912,Sweden-2,0,1,0,1
1912,Sweden-3,0,0,1,1
1912,Sweden-4,0,0,0,0
1912,Switzerland,1,0,0,1
1912,Sydney Rowing Club,0,0,0,0
1912,Taifun,1,0,0,1
1912,Thames Rowing Club,0,1,0,1
1912,Toronto Argonauts,0,0,0,0
1912,Turkey,0,0,0,0
1912,United States,26,18,19,63
1912,Unknown,0,0,0,0
1912,Vaxholm Roddklubb,0,0,0,0
1912,rn-2,0,0,0,0
1920,Ancora,1,0,0,1
1920,Antwerpia V,0,0,1,1
1920,Argentina,0,0,0,0
1920,Atlanta,1,0,0,1
1920,Australia,0,2,1,3
1920,Beatrijs III-1,1,0,0,1
1920,Belgium,15,11,13,39
1920,Belgium-1,0,0,0,0
1920,Belgium-2,0,0,0,0
1920,Belgium-3,0,0,0,0
1920,Belgium-4,0,0,0,0
1920,Boreas-2,0,1,0,1
1920,Brat,0,0,0,0
1920,Brazil,1,1,1,3
1920,Canada,3,3,3,9
1920,Chile,0,0,0,0
1920,Czechoslovakia,0,0,2,2
1920,Czechoslovakia-1,0,0,0,0
1920,Czechoslovakia-3,0,0,0,0
1920,Denmark,3,9,1,13
1920,Edelweiss II-1,1,0,0,1
1920,Egypt,0,0,0,0
1920,Eleda,1,0,0,1
1920,Elsie,0,1,0,1
1920,Estonia,1,2,0,3
1920,Finland,15,10,9,34
1920,Fornebo,0,1,0,1
1920,France,8,19,12,39
1920,France-1,0,0,0,0
1920,France-2,0,0,0,0
1920,France-3,1,0,1,2
1920,Great Britain,12,15,12,39
1920,Great Britain-1,0,0,1,1
1920,Great Britain-2,1,0,0,1
1920,Great Britain-3,0,1,0,1
1920,Great Britain-4,0,0,0,0
1920,Greece,0,1,0,1
1920,Heira II,1,0,0,1
1920,India,0,0,0,0
1920,Irene,1,0,0,1
1920,Italy,14,6,5,25
1920,Japan,0,2,0,2
1920,Jo,1,0,0,1
1920,Kullan,1,0,0,1
1920,Luxembourg,0,1,0,1
1920,Lyn-2,0,1,0,1
1920,Marmi II-1,0,1,0,1
1920,Monaco,0,0,0,0
1920,Mosk II,1,0,0,1
1920,Netherlands,2,1,5,8
1920,New Zealand,0,0,1,1
1920,Norway,6,7,8,21
1920,Oranje,1,0,0,1
1920,Portugal,0,0,0,0
1920,Rose Pompon,0,1,0,1
1920,Sif,1,0,0,1
1920,Sildra-1,1,0,0,1
1920,South Africa,3,4,3,10
1920,South Africa-1,0,0,0,0
1920,South Africa-2,0,0,0,0
1920,Spain,0,2,0,2
1920,Spain-1,0,0,0,0
1920,Spain-2,0,0,0,0
1920,Stella-2,0,0,1,1
1920,Suzy-2,0,0,0,0
1920,Sweden,17,19,25,61
1920,Sweden-1,0,0,0,0
1920,Sweden-2,0,0,0,0
1920,Switzerland,2,2,7,11
1920,Tan-Fe-Pah,0,1,0,1
1920,United States,41,27,27,95
1920,Yugoslavia,0,0,0,0
1924,Aloha II,0,0,0,0
1924,Amolgavar,0,0,0,0
1924,Antwerpia V,0,0,0,0
1924,Argentina,1,3,2,6
1924,Argentina-1,0,0,0,0
1924,Argentina-2,0,0,0,0
1924,Australia,3,1,2,6
1924,Austria,0,3,1,4
1924,Belgium,3,7,3,13
1924,Belgium-1,0,0,0,0
1924,Belgium-2,0,0,0,0
1924,Bera,1,0,0,1
1924,Blue Red,0,0,0,0
1924,Bonzo,0,1,0,1
1924,Brazil,0,0,0,0
1924,Bulgaria,0,0,0,0
1924,Canada,0,3,1,4
1924,Chile,0,0,0,0
1924,Ciss,0,0,0,0
1924,Cuba,0,0,0,0
1924,Czechoslovakia,1,4,5,10
1924,Czechoslovakia-1,0,0,0,0
1924,Czechoslovakia-2,0,0,0,0
1924,Denmark,2,5,3,10
1924,Denmark-1,0,0,0,0
1924,Denmark-2,0,0,0,0
1924,Ecuador,0,0,0,0
1924,Egypt,0,0,0,0
1924,Elisabeth V,1,0,0,1
1924,Emily,0,1,0,1
1924,Estonia,1,1,4,6
1924,Finland,14,13,10,37
1924,Finland-1,0,0,0,0
1924,Finland-2,0,0,0,0
1924,France,14,13,10,37
1924,France-1,0,1,0,1
1924,France-2,0,0,1,1
1924,Great Britain,9,12,11,32
1924,Great Britain-1,0,0,1,1
1924,Great Britain-2,0,1,0,1
1924,Greece,1,0,0,1
1924,Haiti,0,0,1,1
1924,Hatuey,0,0,0,0
1924,Hungary,2,4,4,10
1924,Hungary-1,0,0,0,0
1924,Hungary-2,0,0,0,0
1924,India,0,0,0,0
1924,India-1,0,0,0,0
1924,India-2,0,0,0,0
1924,Ireland,0,1,1,2
1924,Ireland-1,0,0,0,0
1924,Ireland-2,0,0,0,0
1924,Italy,8,3,5,16
1924,Japan,0,0,1,1
1924,Japan-1,0,0,0,0
1924,Japan-2,0,0,0,0
1924,Latvia,0,0,0,0
1924,Lithuania,0,0,0,0
1924,Luxembourg,1,1,0,2
1924,Mebi,0,0,0,0
1924,Mexico,0,0,0,0
1924,Monaco,0,0,1,1
1924,Namoussa,0,0,1,1
1924,Netherlands,4,1,5,10
1924,New Zealand,0,0,1,1
1924,Norway,3,2,3,8
1924,Norway-2,0,0,0,0
1924,Philippines,0,0,0,0
1924,Poland,0,1,1,2
1924,Portugal,0,0,1,1
1924,Romania,0,0,1,1
1924,Russia,0,0,0,0
1924,Sandra,0,0,0,0
1924,South Africa,1,1,1,3
1924,Spain,0,0,0,0
1924,Spain-1,0,0,0,0
1924,Spain-2,0,0,0,0
1924,Sweden,4,13,12,29
1924,Sweden-1,0,0,0,0
1924,Sweden-2,0,0,0,0
1924,Switzerland,7,8,10,25
1924,Switzerland-1,0,0,0,0
1924,Switzerland-2,0,0,0,0
1924,Turkey,0,0,0,0
1924,United States,42,26,27,95
1924,United States-1,2,0,0,2
1924,United States-2,1,1,0,2
1924,Uruguay,1,0,0,1
1924,Willem-Six,0,0,1,1
1924,Yugoslavia,2,0,0,2
1928,Argentina,3,3,1,7
1928,Australia,1,2,1,4
1928,Austria,3,0,1,4
1928,Babe,0,0,0,0
1928,Bamba,0,0,0,0
1928,Belgium,0,1,2,3
1928,Bulgaria,0,0,0,0
1928,Camelia,0,0,0,0
1928,Canada,4,4,7,15
1928,Chile,0,1,0,1
1928,Cuba,0,0,0,0
1928,Cupidon III,0,0,0,0
1928,Cupidon Viking,0,0,0,0
1928,Czechoslovakia,2,5,2,9
1928,Denmark,3,1,4,8
1928,Egypt,2,1,1,4
1928,Estonia,2,1,1,4
1928,Feo,0,0,0,0
1928,Finland,8,8,9,25
1928,France,6,12,6,24
1928,Frieda,0,0,0,0
1928,Fruits,0,0,0,0
1928,Germany,11,9,19,39
1928,Great Britain,4,11,7,22
1928,Greece,0,0,0,0
1928,Haiti,0,1,0,1
1928,Hi-Hi,0,1,0,1
1928,Hollandia,0,1,0,1
1928,Hungaria,0,0,0,0
1928,Hungary,5,5,0,10
1928,India,1,0,0,1
1928,Ingegerd,0,0,0,0
1928,Ireland,1,0,0,1
1928,Italy,7,6,7,20
1928,Japan,2,2,1,5
1928,Kemphaan,0,0,0,0
1928,L'Aile VI,1,0,0,1
1928,Latvia,0,0,0,0
1928,Lithuania,0,0,0,0
1928,Luxembourg,1,0,0,1
1928,Malta,0,0,0,0
1928,Mexico,0,0,0,0
1928,Monaco,0,0,0,0
1928,Netherlands,8,9,5,22
1928,New Zealand,1,0,0,1
1928,Noreg,0,0,0,0
1928,Norna,1,0,0,1
1928,Norway,0,2,1,3
1928,Pan,0,0,0,0
1928,Panama,0,0,0,0
1928,Philippines,0,0,1,1
1928,Poland,2,1,4,7
1928,Portugal,0,0,1,1
1928,Romania,0,0,0,0
1928,South Africa,1,0,2,3
1928,Spain,1,0,0,1
1928,Sweden,7,6,11,24
1928,Switzerland,7,6,4,17
1928,Sylvia,0,0,1,1
1928,Turkey,0,0,0,0
1928,Tutti V,0,0,1,1
1928,Twins II,0,0,0,0
1928,Ubu,0,0,0,0
1928,United States,22,18,16,56
1928,Uruguay,1,0,0,1
1928,Yugoslavia,1,1,3,5
1928,Zimbabwe,0,0,0,0
1932,Angelita,1,0,0,1
1932,Argentina,3,1,0,4
1932,Australia,3,1,1,5
1932,Austria,1,1,3,5
1932,Belgium,0,0,1,1
1932,Bissbi,1,0,0,1
1932,Brazil,0,0,0,0
1932,Bulgaria,0,0,0,0
1932,Canada,2,4,8,14
1932,Caprice,0,0,1,1
1932,China,0,0,0,0
1932,Colombia,0,0,0,0
1932,Cuba,0,0,0,0
1932,Czechoslovakia,1,3,2,6
1932,Denmark,0,5,3,8
1932,El Salvador,0,0,0,0
1932,Estonia,0,0,0,0
1932,Finland,5,8,12,25
1932,France,11,5,4,20
1932,Gallant,0,1,0,1
1932,Germany,5,12,7,24
1932,Great Britain,5,6,5,16
1932,Greece,0,0,0,0
1932,Guatemala,0,0,0,0
1932,Haiti,0,0,0,0
1932,Holland,0,0,0,0
1932,Hungary,6,5,5,16
1932,India,1,0,0,1
1932,Ireland,2,0,0,2
1932,Italy,12,12,12,36
1932,Japan,7,7,4,18
1932,Joy,0,1,0,1
1932,Jupiter,1,0,0,1
1932,Latvia,0,1,0,1
1932,Luxembourg,0,0,0,0
1932,Mexico,0,2,0,2
1932,Monaco,0,0,0,0
1932,Netherlands,2,5,1,8
1932,New Zealand,0,1,0,1
1932,Norway,0,0,0,0
1932,Peru,0,0,0,0
1932,Philippines,0,0,3,3
1932,Poland,3,2,4,9
1932,Portugal,0,0,0,0
1932,Romania,0,0,0,0
1932,Santa Maria,0,1,0,1
1932,South Africa,2,0,3,5
1932,Spain,0,0,1,1
1932,Springbok,0,0,0,0
1932,Sweden,9,5,8,22
1932,Swedish Star,0,0,1,1
1932,Switzerland,0,1,0,1
1932,Tramontane,0,0,0,0
1932,Turkey,0,0,0,0
1932,United States,42,35,30,107
1932,Uruguay,0,0,1,1
1932,Venezuela,0,0,0,0
1932,Windor,0,0,0,0
1932,Yugoslavia,0,0,0,0
1936,Afghanistan,0,0,0,0
1936,Angelita,0,0,0,0
1936,Angerburg,0,0,0,0
1936,Anitra,0,0,0,0
1936,Argentina,2,2,3,7
1936,Augsburg,0,0,0,0
1936,Australia,0,0,1,1
1936,Austria,5,7,5,17
1936,Belgium,0,0,3,3
1936,Bem II,0,0,1,1
1936,Bermuda,0,0,0,0
1936,Bolivia,0,0,0,0
1936,Brandenburg,0,0,0,0
1936,Brazil,0,0,0,0
1936,Bremen,0,0,0,0
1936,Breslau,0,0,0,0
1936,Bulgaria,0,0,0,0
1936,Canada,1,3,5,9
1936,Chile,0,0,0,0
1936,China,0,0,0,0
1936,Colombia,0,0,0,0
1936,Costa Rica,0,0,0,0
1936,Cuxhaven,0,0,0,0
1936,Czechoslovakia,3,5,1,9
1936,Danuta,0,0,0,0
1936,Danzig,0,0,0,0
1936,DeRuyter,0,0,0,0
1936,Denmark,0,2,3,5
1936,Dresden,0,0,0,0
1936,EA II,0,0,0,0
1936,Egypt,2,1,2,5
1936,Esperia,0,0,0,0
1936,Essen,0,0,0,0
1936,Estonia,2,2,3,7
1936,Fada,0,0,0,0
1936,Finland,8,6,6,20
1936,France,7,6,6,19
1936,Freddy,0,0,0,0
1936,Germania II,0,0,1,1
1936,Germany,37,30,31,98
1936,Great Britain,3,7,2,12
1936,Greece,0,0,0,0
1936,Gustel V,0,0,0,0
1936,Hamburg,0,0,0,0
1936,Hannover,0,0,0,0
1936,Heidelberg,0,0,0,0
1936,Hungary,10,1,5,16
1936,Iceland,0,0,0,0
1936,Ilderim,0,0,0,0
1936,India,1,0,0,1
1936,Italia,1,0,0,1
1936,Italy,8,13,5,26
1936,Japan,6,4,10,20
1936,KNS,0,0,0,0
1936,Kiel,0,0,0,0
1936,Kln,0,0,0,0
1936,Knigsberg,0,0,0,0
1936,Konstanz,0,0,0,0
1936,Lalage,1,0,0,1
1936,Latvia,0,1,1,2
1936,Lbeck,0,0,0,0
1936,Leipzig,0,0,0,0
1936,Liechtenstein,0,0,0,0
1936,Lully II,0,1,0,1
1936,Luxembourg,0,0,0,0
1936,Lynn,0,0,0,0
1936,Mainz,0,0,0,0
1936,Malta,0,0,0,0
1936,Marmara,0,0,0,0
1936,Matrero II,0,0,0,0
1936,May Be,0,0,1,1
1936,Mexico,0,0,3,3
1936,Monaco,0,0,0,0
1936,Myojo,0,0,0,0
1936,Mystery,0,0,0,0
1936,Netherlands,5,4,6,15
1936,New Zealand,1,0,0,1
1936,Norway,1,1,2,4
1936,Nrnberg,1,0,0,1
1936,Paka,0,0,0,0
1936,Pegaso,0,0,0,0
1936,Peru,0,0,0,0
1936,Philippines,0,0,1,1
1936,Poland,0,4,5,9
1936,Portugal,0,0,1,1
1936,Potsdam,0,0,1,1
1936,Qu'Importe,0,0,0,0
1936,Romania,0,1,0,1
1936,Rostock,0,1,0,1
1936,Saskia,0,0,0,0
1936,Sheerio,0,0,0,0
1936,Silja,0,1,0,1
1936,South Africa,0,1,0,1
1936,Sunshine,0,1,0,1
1936,Sweden,6,4,9,19
1936,Switzerland,4,9,5,18
1936,Three Star Too,0,0,0,0
1936,Turkey,1,0,1,2
1936,United States,24,21,12,57
1936,Uruguay,0,0,0,0
1936,Vicking,0,0,0,0
1936,Wannsee,1,0,0,1
1936,Wiking,0,0,0,0
1936,Ylliam II,0,0,0,0
1936,Yugoslavia,0,1,0,1
1948,Acturus,0,0,0,0
1948,Afghanistan,0,0,0,0
1948,Ali-Baba II,0,0,1,1
1948,Allegro,0,0,0,0
1948,Aloha II,0,0,0,0
1948,Andorinha,0,0,0,0
1948,Antares,0,0,0,0
1948,Apache,0,0,0,0
1948,Argentina,3,2,1,6
1948,Argus,0,0,0,0
1948,Ariel,0,0,0,0
1948,Ausonia,0,0,0,0
1948,Australia,2,6,5,13
1948,Austria,2,2,4,8
1948,Belgium,2,2,3,7
1948,Bermuda,0,0,0,0
1948,Brazil,0,0,1,1
1948,Buscape II,0,0,0,0
1948,Canada,0,2,2,4
1948,Ceres II,0,0,0,0
1948,Chance,0,0,0,0
1948,Chile,0,0,0,0
1948,China,0,0,0,0
1948,Ciocca II,0,0,0,0
1948,Colombia,0,0,0,0
1948,Cuba,0,0,0,0
1948,Czechoslovakia,6,2,3,11
1948,Denmark,5,8,8,21
1948,Djinn,0,1,0,1
1948,Dolfijn,0,0,0,0
1948,Donar III,0,0,0,0
1948,Egypt,2,2,1,5
1948,Enotria,0,0,0,0
1948,Espardate,0,0,0,0
1948,Finland,8,8,6,22
1948,France,11,6,15,32
1948,Galerna,0,0,0,0
1948,Gem II,0,0,0,0
1948,Great Britain,3,16,7,26
1948,Greece,0,0,0,0
1948,Guyana,0,0,0,0
1948,Hilarius,1,0,0,1
1948,Hungary,10,5,12,27
1948,Iceland,0,0,0,0
1948,India,1,0,0,1
1948,Iran,0,0,1,1
1948,Iraq,0,0,0,0
1948,Ireland,0,0,1,1
1948,Italy,9,12,10,31
1948,Jamaica,1,2,0,3
1948,Johan,0,0,0,0
1948,Joy,0,0,0,0
1948,Kurush II,0,1,0,1
1948,LaBandera,0,0,0,0
1948,Lalage,0,0,0,0
1948,Lebanon,0,0,0,0
1948,Legionario,0,0,0,0
1948,Liechtenstein,0,0,0,0
1948,Llanoria,1,0,0,1
1948,Lotta IV,0,0,0,0
1948,Lucky Star,0,0,0,0
1948,Luxembourg,0,0,0,0
1948,Malta,0,0,0,0
1948,Margaret,0,0,1,1
1948,Mexico,2,1,2,5
1948,Monaco,0,0,0,0
1948,Moorina,0,0,0,0
1948,Morena,0,0,0,0
1948,Myanmar,0,0,0,0
1948,Nephos I,0,0,0,0
1948,Netherlands,5,2,8,15
1948,New Zealand,0,0,0,0
1948,Nora,0,0,0,0
1948,Nortazo,0,0,0,0
1948,Norway,0,3,3,6
1948,Pakistan,0,0,0,0
1948,Pampero,0,0,0,0
1948,Pan,1,0,0,1
1948,Panama,0,0,2,2
1948,Peru,1,0,0,1
1948,Philippines,0,0,0,0
1948,Poland,1,0,1,2
1948,Portugal,0,0,1,1
1948,Puerto Rico,0,0,1,1
1948,Raili,0,0,0,0
1948,Red Indian,0,0,0,0
1948,Rhythm,0,0,0,0
1948,Scaup,0,0,0,0
1948,Singapore,0,0,0,0
1948,Slaghoken,0,1,0,1
1948,Snap,0,0,1,1
1948,South Africa,2,2,2,6
1948,South Korea,0,0,2,2
1948,Spain,0,1,0,1
1948,Sri Lanka,0,1,0,1
1948,St. Margrite,0,0,0,0
1948,Starita,0,0,1,1
1948,Sweden,17,10,17,44
1948,Swift,1,0,0,1
1948,Switzerland,5,12,5,22
1948,Symphony,0,1,0,1
1948,Syria,0,0,0,0
1948,The Cloud,0,0,0,0
1948,Trinidad and Tobago,0,1,0,1
1948,Turkey,6,4,2,12
1948,United States,36,27,18,81
1948,Uruguay,0,1,1,2
1948,Venezuela,0,0,0,0
1948,Vinha,0,0,0,0
1948,Ylliam VII,0,0,0,0
1948,Yugoslavia,0,2,0,2
1952,30. Februar,0,0,0,0
1952,Alcaid,0,0,0,0
1952,Ali-Baba IV,0,0,0,0
1952,Arcturus,0,0,0,0
1952,Argentina,1,2,2,5
1952,Australia,6,2,3,11
1952,Austria,0,1,1,2
1952,Bahamas,0,0,0,0
1952,Belgium,2,2,0,4
1952,Bem II,0,0,0,0
1952,Bermuda,0,0,0,0
1952,Brazil,1,0,2,3
1952,Bu III,0,0,0,0
1952,Bulgaria,0,0,1,1
1952,Burevestnik,0,0,0,0
1952,Canada,1,2,0,3
1952,Chile,0,2,0,2
1952,China,0,0,0,0
1952,Ciocca,0,0,0,0
1952,Comanche,0,1,0,1
1952,Complex II,1,0,0,1
1952,Cuba,0,0,0,0
1952,Czechoslovakia,7,3,3,13
1952,Damoiselle,0,0,0,0
1952,DeRuyter,0,0,0,0
1952,Denmark,2,1,3,6
1952,Djinn,0,0,0,0
1952,Egypt,0,0,1,1
1952,Eissero VI,0,0,0,0
1952,Elisabeth X,0,1,0,1
1952,Encore,0,1,0,1
1952,Escapade,0,0,0,0
1952,Espadarte,0,0,1,1
1952,Finland,6,3,12,21
1952,Fortuna,0,0,0,0
1952,France,6,6,6,18
1952,Galatea II,0,0,0,0
1952,Gem III,0,0,0,0
1952,Germany,0,7,16,23
1952,Ghana,0,0,0,0
1952,Girl Pat,0,0,0,0
1952,Great Britain,1,2,8,11
1952,Greece,0,0,0,0
1952,Guatemala,0,0,0,0
1952,Gullvinge,0,0,0,0
1952,Gustel X,0,0,1,1
1952,Guyana,0,0,0,0
1952,Hirondelle,0,0,0,0
1952,Hojwa,0,0,1,1
1952,Hong Kong,0,0,0,0
1952,Hornet,0,0,0,0
1952,Hungary,16,10,16,42
1952,Iceland,0,0,0,0
1952,India,1,0,1,2
1952,Indonesia,0,0,0,0
1952,Iran,0,3,4,7
1952,Ireland,0,1,0,1
1952,Israel,0,0,0,0
1952,Italy,7,9,4,20
1952,Jamaica,2,3,0,5
1952,Japan,1,6,1,8
1952,Jet,0,0,0,0
1952,Jill,0,0,0,0
1952,Korshun,0,0,0,0
1952,Kurush IV,0,0,0,0
1952,Lebanon,0,1,1,2
1952,Liechtenstein,0,0,0,0
1952,Llanoria,1,0,0,1
1952,Lotta IV,0,0,0,0
1952,Lucky Star,0,0,0,0
1952,Luxembourg,1,0,0,1
1952,Marie-Tim,0,0,0,0
1952,May Be VII,0,0,0,0
1952,Merope,1,0,0,1
1952,Mexico,0,1,0,1
1952,Mirtala,0,0,0,0
1952,Monaco,0,0,0,0
1952,Myanmar,0,0,0,0
1952,Netherlands,0,5,0,5
1952,Netherlands Antilles,0,0,0,0
1952,New Zealand,1,0,2,3
1952,Nigeria,0,0,0,0
1952,Nirwana,0,0,0,0
1952,Norway,2,0,0,2
1952,Paka V,0,0,0,0
1952,Pakistan,0,0,0,0
1952,Pampero,0,0,0,0
1952,Pan,1,0,0,1
1952,Panama,0,0,0,0
1952,Philippines,0,0,0,0
1952,Poland,1,2,1,4
1952,Portugal,0,0,0,0
1952,Primorka,0,0,0,0
1952,Puerto Rico,0,0,0,0
1952,Ralia,0,0,1,1
1952,Romania,1,1,2,4
1952,Saar,0,0,0,0
1952,Sabre,0,0,0,0
1952,Shoveller,0,0,0,0
1952,Singapore,0,0,0,0
1952,Sjhxa,0,0,0,0
1952,Skidoo,0,0,0,0
1952,Snude,0,0,0,0
1952,South Africa,2,4,4,10
1952,South Korea,0,0,2,2
1952,South Vietnam,0,0,0,0
1952,Soviet Union,22,29,19,70
1952,Spain,0,1,0,1
1952,Sri Lanka,0,0,0,0
1952,Sweden,12,12,9,33
1952,Switzerland,2,6,6,14
1952,Teresita,0,0,0,0
1952,Thailand,0,0,0,0
1952,Thalatta,0,0,0,0
1952,Tim-Tam III,0,0,0,0
1952,Titia,0,0,0,0
1952,Tom Kyle,0,0,0,0
1952,Tornado,0,1,0,1
1952,Trickson VI,0,0,0,0
1952,Trinidad and Tobago,0,0,2,2
1952,Tu-Fri,0,0,0,0
1952,Turkey,2,0,1,3
1952,Unique,0,0,0,0
1952,United States,38,18,17,73
1952,Uragan,0,0,0,0
1952,Uruguay,0,0,2,2
1952,Venezuela,0,0,1,1
1952,Vinha,0,0,0,0
1952,Virginie,0,0,0,0
1952,Whirlaway,0,0,0,0
1952,Yeoman,0,0,0,0
1952,Ylliam VIII,0,0,0,0
1952,Yugoslavia,1,2,0,3
1956,Afghanistan,0,0,0,0
1956,Aretusa,0,0,0,0
1956,Argentina,0,1,1,2
1956,Australia,13,7,13,33
1956,Austria,0,0,2,2
1956,Bahamas,0,0,0,0
1956,Beaver,0,0,0,0
1956,Belgium,0,2,0,2
1956,Bluebottle,0,0,1,1
1956,Brazil,1,0,0,1
1956,Bulgaria,1,3,1,5
1956,Buraddoo,0,0,1,1
1956,Cambodia,0,0,0,0
1956,Canada,2,1,3,6
1956,Canopus,0,0,0,0
1956,Chile,0,2,2,4
1956,Chinese Taipei,0,0,0,0
1956,Chuckles,0,0,1,1
1956,Colombia,0,0,0,0
1956,Covunco III,0,0,0,0
1956,Cuba,0,0,0,0
1956,Czechoslovakia,1,4,1,6
1956,Denmark,1,1,1,3
1956,Druzhba,0,0,0,0
1956,Egypt,0,0,0,0
1956,Ethiopia,0,0,0,0
1956,Falcon IV,0,1,0,1
1956,Faneca,0,0,0,0
1956,Fiji,0,0,0,0
1956,Finland,3,1,11,15
1956,France,4,4,6,14
1956,Gam II,0,0,0,0
1956,Gem IV,0,0,1,1
1956,Germany,6,13,7,26
1956,Gilliatt V,0,0,0,0
1956,Great Britain,6,6,9,21
1956,Greece,0,0,1,1
1956,Gustl XI,0,0,0,0
1956,Guyana,0,0,0,0
1956,Hong Kong,0,0,0,0
1956,Hungary,9,10,7,26
1956,Iceland,0,1,0,1
1956,Impala,0,0,0,0
1956,Inca,0,0,0,0
1956,India,1,0,0,1
1956,Indonesia,0,0,0,0
1956,Iran,2,2,1,5
1956,Ireland,1,1,3,5
1956,Israel,0,0,0,0
1956,Italy,8,7,9,24
1956,Jamaica,0,0,0,0
1956,Japan,4,10,3,17
1956,Jest,1,0,0,1
1956,Kannibaltje,0,0,0,0
1956,Kathleen,1,0,0,1
1956,Kenya,0,0,0,0
1956,Kingfisher,0,0,0,0
1956,Kon-Tiki,0,0,0,0
1956,Kurush IV,0,0,0,0
1956,Liberia,0,0,0,0
1956,Luxembourg,0,0,0,0
1956,Malaya,0,0,0,0
1956,Manana,0,0,0,0
1956,Merope III,0,1,0,1
1956,Mexico,1,0,1,2
1956,Myanmar,0,0,0,0
1956,Naiad,0,0,0,0
1956,Neptun II,0,0,0,0
1956,Netherlands,0,0,0,0
1956,New Zealand,1,0,0,1
1956,Nigeria,0,0,0,0
1956,Nikh,0,0,0,0
1956,North Borneo,0,0,0,0
1956,Norway,1,0,2,3
1956,Pakistan,0,1,0,1
1956,Pam,0,0,0,0
1956,Pampero,0,0,0,0
1956,Pan II,0,0,0,0
1956,Paula,0,0,0,0
1956,Peru,0,0,0,0
1956,Philippines,0,0,0,0
1956,Poland,1,4,4,9
1956,Portugal,0,0,0,0
1956,Puerto Rico,0,0,0,0
1956,Red Dragon,0,0,0,0
1956,Rika II,0,0,0,0
1956,Romania,5,3,5,13
1956,Romolo,0,0,0,0
1956,Rush IV,0,0,0,0
1956,Rush V,1,0,0,1
1956,Singapore,0,0,0,0
1956,Slaghoken II,1,0,0,1
1956,South Africa,0,0,4,4
1956,South Korea,0,1,1,2
1956,South Vietnam,0,0,0,0
1956,Soviet Union,37,29,32,98
1956,Spain,0,0,0,0
1956,Spirit III,0,0,0,0
1956,Sri Lanka,0,0,0,0
1956,Starlight III,0,0,0,0
1956,Sweden,6,5,6,17
1956,Switzerland,0,0,1,1
1956,Thailand,0,0,0,0
1956,Tichiboo,0,0,0,0
1956,Tilly,0,0,0,0
1956,Tineke,0,0,0,0
1956,Tip,0,1,0,1
1956,Tomahawk II,0,0,0,0
1956,Trinidad and Tobago,0,0,0,0
1956,Tulilind,0,0,0,0
1956,Turkey,3,2,2,7
1956,Twins VIII,0,0,0,0
1956,Uganda,0,0,0,0
1956,United States,31,25,17,73
1956,Uruguay,0,0,1,1
1956,Venezuela,0,0,0,0
1956,Viking,0,0,0,0
1956,Vision,0,1,0,1
1956,Wendehals,0,0,0,0
1956,Xantippa,0,0,0,0
1956,Yeoman V,0,0,0,0
1956,Yugoslavia,0,3,0,3
1960,Afghanistan,0,0,0,0
1960,Aldebaran II,0,0,0,0
1960,Aletta,0,0,0,0
1960,Ali-Baba VI,0,0,0,0
1960,Ardilla,0,0,0,0
1960,Argentina,0,0,1,1
1960,Argo II,0,0,0,0
1960,Astrid III,0,0,0,0
1960,Australia,8,8,6,22
1960,Austria,1,1,0,2
1960,Baccara,0,0,0,0
1960,Bahamas,0,0,0,0
1960,Bajazzo,0,0,0,0
1960,Balaton,0,0,0,0
1960,Ballerina IV,0,0,1,1
1960,Beaver,0,0,0,0
1960,Belgium,0,2,2,4
1960,Bella,0,0,0,0
1960,Bellatrix IX,0,0,0,0
1960,Bermuda,0,0,0,0
1960,Bermudes,0,0,0,0
1960,Bermudian,0,0,0,0
1960,Bim,0,0,0,0
1960,Boreas,0,0,0,0
1960,Brazil,0,0,2,2
1960,Bronia,0,0,0,0
1960,Bulgaria,1,3,3,7
1960,Buraddoo,0,0,0,0
1960,Calcinhas,0,0,0,0
1960,Calypse II,0,0,0,0
1960,Canada,0,1,0,1
1960,Canopus,0,0,0,0
1960,Cha-Cha III,0,0,0,0
1960,Chamukina,0,0,0,0
1960,Chile,0,0,0,0
1960,Chinese Taipei,0,1,0,1
1960,Chok,0,0,0,0
1960,Ciocca III,0,0,0,0
1960,Circus,0,0,0,0
1960,Colombia,0,0,0,0
1960,Combine,0,0,0,0
1960,Cuba,0,0,0,0
1960,Czechoslovakia,3,2,3,8
1960,Daisy,0,0,0,0
1960,Damoiselle IV,0,0,0,0
1960,Danaldo,0,0,0,0
1960,Denmark,2,1,1,4
1960,Dinah V,0,0,0,0
1960,Espuma del Mar,0,0,0,0
1960,Ethiopia,1,0,0,1
1960,Evita VI,0,0,0,0
1960,Falcon VI,0,0,0,0
1960,Fantasio III,0,0,0,0
1960,Fiji,0,0,0,0
1960,Finland,1,1,3,5
1960,France,0,2,3,5
1960,Frip IV,0,0,0,0
1960,Gabbiano,0,0,0,0
1960,Galejan,0,0,0,0
1960,Gem VII,0,0,0,0
1960,Germany,12,19,10,41
1960,Ghana,0,1,0,1
1960,Great Britain,2,6,12,20
1960,Greece,0,0,0,0
1960,Grifo III,0,0,0,0
1960,Guyana,0,0,0,0
1960,Haiti,0,0,0,0
1960,Hakahana,0,0,0,0
1960,Harmony,0,0,0,0
1960,Hong Kong,0,0,0,0
1960,Hungary,6,8,7,21
1960,Iceland,0,0,0,0
1960,India,0,1,0,1
1960,Indonesia,0,0,0,0
1960,Inga-Lill XXXXIII,0,0,0,0
1960,Iran,0,1,3,4
1960,Iraq,0,0,1,1
1960,Ireland,0,0,0,0
1960,Israel,0,0,0,0
1960,Italy,13,10,12,35
1960,Japan,4,7,7,18
1960,John B,0,0,0,0
1960,June Climene,0,0,0,0
1960,Kenya,0,0,0,0
1960,Lasha,0,0,0,0
1960,Lebanon,0,0,0,0
1960,Lett,0,0,0,0
1960,Liberia,0,0,0,0
1960,Liechtenstein,0,0,0,0
1960,Luxembourg,0,0,0,0
1960,Ma'Lindo,0,1,0,1
1960,Macky VI,0,0,1,1
1960,Mad Dog,0,0,0,0
1960,Maid of Lebanon,0,0,0,0
1960,Malaya,0,0,0,0
1960,Malta,0,0,0,0
1960,Mari,0,0,0,0
1960,May-Be 1960,0,0,0,0
1960,Merope,0,0,0,0
1960,Merope III,0,0,0,0
1960,Meteor,0,0,0,0
1960,Mexico,0,0,1,1
1960,Minotaur,1,0,0,1
1960,Mizar,0,0,0,0
1960,Monaco,0,0,0,0
1960,Morocco,0,1,0,1
1960,Myanmar,0,0,0,0
1960,Netherlands,0,1,2,3
1960,Netherlands Antilles,0,0,0,0
1960,New Zealand,2,0,1,3
1960,Nigeria,0,0,0,0
1960,Nirefs,1,0,0,1
1960,Nokaut II,0,0,0,0
1960,Norway,0,0,0,0
1960,Oleander II,0,0,0,0
1960,Olimpia,0,0,0,0
1960,Olympion,0,0,0,0
1960,Pakaria,0,0,0,0
1960,Pakistan,1,0,1,2
1960,Panama,0,0,0,0
1960,Partenope,0,0,0,0
1960,Pasodoble,0,0,0,0
1960,Patricia,0,0,0,0
1960,Peri,0,0,0,0
1960,Persey,0,0,0,0
1960,Peru,0,0,0,0
1960,Philippines,0,0,0,0
1960,Pimm,0,0,0,0
1960,Poland,4,6,11,21
1960,Portugal,0,0,0,0
1960,Posillipo III,0,0,0,0
1960,Puerto Rico,0,0,0,0
1960,Rhodesia,0,0,0,0
1960,Rififi,0,0,0,0
1960,Romania,3,1,6,10
1960,SagaII,0,0,0,0
1960,Salamander,0,0,0,0
1960,San Marino,0,0,0,0
1960,Scram,0,0,0,0
1960,Shrew II,0,0,1,1
1960,Siames-Cat,0,0,0,0
1960,Singapore,0,1,0,1
1960,Sirene,1,0,0,1
1960,Sjovinge,0,0,0,0
1960,Skum,0,1,0,1
1960,Snowten III,0,0,0,0
1960,South Africa,0,1,2,3
1960,South Korea,0,0,0,0
1960,South Vietnam,0,0,0,0
1960,Soviet Union,42,29,31,102
1960,Spain,0,0,1,1
1960,Spirit VI,0,0,0,0
1960,Sri Lanka,0,0,0,0
1960,Struten,0,0,0,0
1960,Sudan,0,0,0,0
1960,Surprise,0,0,0,0
1960,Sweden,1,2,3,6
1960,Switzerland,0,3,2,5
1960,Tajamar,0,0,0,0
1960,Tango,0,1,0,1
1960,Tengiri,0,0,0,0
1960,Terrible,0,0,0,0
1960,Thailand,0,0,0,0
1960,Three Leaves,0,0,0,0
1960,Tornado,1,0,0,1
1960,Trintel II,0,0,0,0
1960,Tunisia,0,0,0,0
1960,Turkey,7,2,0,9
1960,Twinkle,0,0,0,0
1960,Uganda,0,0,0,0
1960,United Arab Republic,0,1,1,2
1960,United States,33,21,15,69
1960,Uruguay,0,0,0,0
1960,Venezuela,0,0,1,1
1960,Venilia,0,0,1,1
1960,Vesania,0,0,0,0
1960,Viktoriya,0,0,0,0
1960,Vim III,0,0,0,0
1960,Voloira II,0,0,0,0
1960,Web II,0,1,0,1
1960,West Indies Federation,0,0,2,2
1960,Yangon,0,0,0,0
1960,Yeoman VII,0,0,0,0
1960,Yugoslavia,1,1,0,2
1960,Zefyros,0,0,0,0
1960,Zimbabwe,0,0,0,0
1964,Acipactli,0,0,0,0
1964,Afghanistan,0,0,0,0
1964,Akatonbo,0,0,0,0
1964,Alain IV,0,0,0,0
1964,Aldebaran,0,0,0,0
1964,Algeria,0,0,0,0
1964,Ali-Baba IX,0,0,0,0
1964,Almaz,0,0,0,0
1964,Andromeda,0,0,0,0
1964,Aphrodite,0,0,1,1
1964,Argentina,0,1,0,1
1964,Argeste,0,0,0,0
1964,Australia,5,2,10,17
1964,Austria,0,0,0,0
1964,Bahamas,0,0,0,0
1964,Barco Deloro,0,0,0,0
1964,Barrenjoey,1,0,0,1
1964,Belgium,2,0,1,3
1964,Bellatrix XIII,0,0,0,0
1964,Bermuda,0,0,0,0
1964,Bingo,0,0,1,1
1964,Bolivia,0,0,0,0
1964,Brazil,0,0,1,1
1964,Brigantia,0,0,0,0
1964,Bulgaria,3,5,2,10
1964,Cambodia,0,0,0,0
1964,Cambria,0,0,0,0
1964,Cameroon,0,0,0,0
1964,Canada,1,2,1,4
1964,Chad,0,0,0,0
1964,Chaje II,0,0,0,0
1964,Chile,0,0,0,0
1964,Chinese Taipei,0,0,0,0
1964,Clementine V,0,0,0,0
1964,Colombia,0,0,0,0
1964,Congo (Brazzaville),0,0,0,0
1964,Costa Rica,0,0,0,0
1964,Cote d'Ivoire,0,0,0,0
1964,Cuba,0,1,0,1
1964,Czechoslovakia,5,6,3,14
1964,Daisy,0,0,0,0
1964,Denmark,1,1,3,5
1964,Diablo,0,0,0,0
1964,Dominican Republic,0,0,0,0
1964,Druzhba,0,0,0,0
1964,Egypt,0,0,0,0
1964,Espuma del Mar,0,0,0,0
1964,Ethiopia,1,0,0,1
1964,Faneca,0,0,0,0
1964,Finland,3,0,2,5
1964,Firebird II,0,0,0,0
1964,Fram III,0,0,0,0
1964,France,1,8,6,15
1964,Gem,1,0,0,1
1964,Germany,10,21,18,49
1964,Ghana,0,0,1,1
1964,Glider,0,1,0,1
1964,Glisten,0,0,0,0
1964,Great Britain,4,11,2,17
1964,Greece,0,0,0,0
1964,Grifo IV,0,0,0,0
1964,Grifone,0,0,0,0
1964,Guanahani,0,0,0,0
1964,Guyana,0,0,0,0
1964,GyoshuII,0,0,0,0
1964,Hayama,0,0,0,0
1964,Hong Kong,0,0,0,0
1964,Humbug V,0,0,1,1
1964,Hungary,10,7,5,22
1964,Iceland,0,0,0,0
1964,India,1,0,0,1
1964,Iran,0,0,2,2
1964,Iraq,0,0,0,0
1964,Ireland,0,0,1,1
1964,Israel,0,0,0,0
1964,Italy,10,10,7,27
1964,Jamaica,0,0,0,0
1964,Japan,16,5,8,29
1964,John B,0,0,0,0
1964,Kalayaan,0,0,0,0
1964,Kenya,0,0,1,1
1964,Kuling,0,0,0,0
1964,Lady C,0,1,0,1
1964,Lebanon,0,0,0,0
1964,Liberia,0,0,0,0
1964,Liechtenstein,0,0,0,0
1964,Linglom,0,0,0,0
1964,Lucky,0,0,0,0
1964,Luxembourg,0,0,0,0
1964,Madagascar,0,0,0,0
1964,Malaysia,0,0,0,0
1964,Mali,0,0,0,0
1964,Maryke,0,0,0,0
1964,Mexico,0,0,1,1
1964,Miss Denmark 1964,0,0,0,0
1964,Miss Nippon IV,0,0,0,0
1964,Miss Nippon V,0,0,0,0
1964,MitaII,0,0,0,0
1964,Monaco,0,0,0,0
1964,Mongolia,0,0,0,0
1964,Monica,0,0,0,0
1964,Morocco,0,0,0,0
1964,Mutafo,0,1,0,1
1964,Myanmar,0,0,0,0
1964,Nausikaa 4,0,0,0,0
1964,Nepal,0,0,0,0
1964,Netherlands,2,4,4,10
1964,Netherlands Antilles,0,0,0,0
1964,New Zealand,2,0,2,4
1964,Niger,0,0,0,0
1964,Nigeria,0,0,1,1
1964,Norway,0,0,0,0
1964,Oleander XII,0,0,0,0
1964,Olen,0,0,0,0
1964,Pakistan,0,1,0,1
1964,Panama,0,0,0,0
1964,Pandora,1,0,0,1
1964,Peri II,0,0,0,0
1964,Peru,0,0,0,0
1964,Philippines,0,1,0,1
1964,Phoenix,0,0,0,0
1964,Pigoule,0,0,0,0
1964,Poland,7,6,10,23
1964,Portugal,0,0,0,0
1964,Pousse-Moi Pas VII,0,0,0,0
1964,Proteus II,0,0,0,0
1964,Puerto Rico,0,0,0,0
1964,Rampage,0,0,0,0
1964,Riccar,0,0,0,0
1964,Romania,2,4,6,12
1964,Roy,0,0,0,0
1964,Rush VII,0,1,0,1
1964,Senegal,0,0,0,0
1964,Serendipity,0,0,0,0
1964,South Korea,0,2,1,3
1964,South Vietnam,0,0,0,0
1964,Soviet Union,30,30,33,93
1964,Spain,0,0,0,0
1964,Squid III,0,0,0,0
1964,Sri Lanka,0,0,0,0
1964,State VI,0,0,0,0
1964,Subbnboana,0,0,0,0
1964,Sweden,2,1,3,6
1964,Switzerland,1,2,1,4
1964,Syndi,0,0,0,0
1964,Taifun,0,0,0,0
1964,Tango,0,0,0,0
1964,Tantalus,0,0,0,0
1964,Tanzania,0,0,0,0
1964,Thailand,0,0,0,0
1964,Tlaloc,0,0,0,0
1964,Trinidad and Tobago,0,1,2,3
1964,Tunisia,0,1,1,2
1964,Turkey,2,3,1,6
1964,Uganda,0,0,0,0
1964,Umberta V,0,0,0,0
1964,United States,36,25,25,86
1964,Uruguay,0,0,1,1
1964,Venezuela,0,0,0,0
1964,Vento Sul,0,0,0,0
1964,Web III,0,0,0,0
1964,White Lady,1,0,0,1
1964,Widgeon,0,0,1,1
1964,Xolotl,0,0,0,0
1964,Yeoman XII,0,0,0,0
1964,Yugoslavia,2,1,2,5
1964,Zambia,0,0,0,0
1964,Zimbabwe,0,0,0,0
1968,Afghanistan,0,0,0,0
1968,Algeria,0,0,0,0
1968,Argentina,0,0,2,2
1968,Australia,5,7,5,17
1968,Austria,0,2,2,4
1968,Bahamas,0,0,0,0
1968,Barbados,0,0,0,0
1968,Belgium,0,1,1,2
1968,Belize,0,0,0,0
1968,Bermuda,0,0,0,0
1968,Bolivia,0,0,0,0
1968,Brazil,0,1,2,3
1968,Bulgaria,2,4,3,9
1968,Cameroon,0,1,0,1
1968,Canada,1,3,1,5
1968,Central African Republic,0,0,0,0
1968,Chad,0,0,0,0
1968,Chile,0,0,0,0
1968,Chinese Taipei,0,0,1,1
1968,Colombia,0,0,0,0
1968,Congo (Kinshasa),0,0,0,0
1968,Costa Rica,0,0,0,0
1968,Cote d'Ivoire,0,0,0,0
1968,Cuba,0,4,0,4
1968,Czechoslovakia,7,2,4,13
1968,Denmark,1,4,3,8
1968,Dominican Republic,0,0,0,0
1968,East Germany,9,9,7,25
1968,Ecuador,0,0,0,0
1968,Egypt,0,0,0,0
1968,El Salvador,0,0,0,0
1968,Ethiopia,1,1,0,2
1968,Fiji,0,0,0,0
1968,Finland,1,2,1,4
1968,France,7,3,5,15
1968,Ghana,0,0,0,0
1968,Great Britain,5,5,3,13
1968,Greece,0,0,1,1
1968,Guatemala,0,0,0,0
1968,Guinea,0,0,0,0
1968,Guyana,0,0,0,0
1968,Honduras,0,0,0,0
1968,Hong Kong,0,0,0,0
1968,Hungary,10,10,12,32
1968,Iceland,0,0,0,0
1968,India,0,0,1,1
1968,Indonesia,0,0,0,0
1968,Iran,2,1,2,5
1968,Iraq,0,0,0,0
1968,Ireland,0,0,0,0
1968,Israel,0,0,0,0
1968,Italy,3,4,9,16
1968,Jamaica,0,1,0,1
1968,Japan,11,7,7,25
1968,Kenya,3,4,2,9
1968,Kuwait,0,0,0,0
1968,Lebanon,0,0,0,0
1968,Libya,0,0,0,0
1968,Liechtenstein,0,0,0,0
1968,Luxembourg,0,0,0,0
1968,Madagascar,0,0,0,0
1968,Malaysia,0,0,0,0
1968,Mali,0,0,0,0
1968,Malta,0,0,0,0
1968,Mexico,3,3,3,9
1968,Monaco,0,0,0,0
1968,Mongolia,0,1,3,4
1968,Morocco,0,0,0,0
1968,Myanmar,0,0,0,0
1968,Netherlands,3,3,1,7
1968,Netherlands Antilles,0,0,0,0
1968,New Zealand,1,0,2,3
1968,Nicaragua,0,0,0,0
1968,Niger,0,0,0,0
1968,Nigeria,0,0,0,0
1968,Norway,1,1,0,2
1968,Pakistan,1,0,0,1
1968,Panama,0,0,0,0
1968,Paraguay,0,0,0,0
1968,Peru,0,0,0,0
1968,Philippines,0,0,0,0
1968,Poland,5,2,11,18
1968,Portugal,0,0,0,0
1968,Puerto Rico,0,0,0,0
1968,Romania,4,6,5,15
1968,San Marino,0,0,0,0
1968,Senegal,0,0,0,0
1968,Sierra Leone,0,0,0,0
1968,Singapore,0,0,0,0
1968,South Korea,0,1,1,2
1968,South Vietnam,0,0,0,0
1968,Soviet Union,29,32,30,91
1968,Spain,0,0,0,0
1968,Sri Lanka,0,0,0,0
1968,Sudan,0,0,0,0
1968,Suriname,0,0,0,0
1968,Sweden,2,1,1,4
1968,Switzerland,0,1,4,5
1968,Syria,0,0,0,0
1968,Tanzania,0,0,0,0
1968,Thailand,0,0,0,0
1968,Trinidad and Tobago,0,0,0,0
1968,Tunisia,1,0,1,2
1968,Turkey,2,0,0,2
1968,Uganda,0,1,1,2
1968,United States,45,28,34,107
1968,United States Virgin Islands,0,0,0,0
1968,Uruguay,0,0,0,0
1968,Venezuela,1,0,0,1
1968,West Germany,5,11,10,26
1968,Yugoslavia,3,3,2,8
1968,Zambia,0,0,0,0
1972,Afghanistan,0,0,0,0
1972,Albania,0,0,0,0
1972,Algeria,0,0,0,0
1972,Argentina,0,1,0,1
1972,Australia,8,7,2,17
1972,Austria,0,1,2,3
1972,Bahamas,0,0,0,0
1972,Barbados,0,0,0,0
1972,Belgium,0,2,0,2
1972,Belize,0,0,0,0
1972,Benin,0,0,0,0
1972,Bermuda,0,0,0,0
1972,Bolivia,0,0,0,0
1972,Brazil,0,0,2,2
1972,Bulgaria,6,10,5,21
1972,Burkina Faso,0,0,0,0
1972,Cambodia,0,0,0,0
1972,Cameroon,0,0,0,0
1972,Canada,0,2,3,5
1972,Chad,0,0,0,0
1972,Chile,0,0,0,0
1972,Chinese Taipei,0,0,0,0
1972,Colombia,0,1,2,3
1972,Congo (Brazzaville),0,0,0,0
1972,Costa Rica,0,0,0,0
1972,Cote d'Ivoire,0,0,0,0
1972,Cuba,3,1,4,8
1972,Czechoslovakia,2,4,2,8
1972,Czechoslovakia-1,0,0,0,0
1972,Czechoslovakia-2,0,0,0,0
1972,Czechoslovakia-3,0,0,0,0
1972,Denmark,1,0,0,1
1972,Dominican Republic,0,0,0,0
1972,East Germany,19,23,23,65
1972,East Germany-1,1,0,0,1
1972,East Germany-2,0,0,0,0
1972,East Germany-3,0,0,0,0
1972,Ecuador,0,0,0,0
1972,Egypt,0,0,0,0
1972,El Salvador,0,0,0,0
1972,Ethiopia,0,0,2,2
1972,Fiji,0,0,0,0
1972,Finland,3,1,4,8
1972,France,2,4,7,13
1972,Gabon,0,0,0,0
1972,Ghana,0,0,1,1
1972,Great Britain,4,5,9,18
1972,Great Britain-1,0,0,0,0
1972,Great Britain-2,0,0,0,0
1972,Greece,0,2,0,2
1972,Guatemala,0,0,0,0
1972,Guyana,0,0,0,0
1972,Haiti,0,0,0,0
1972,Hong Kong,0,0,0,0
1972,Hungary,6,13,16,35
1972,Iceland,0,0,0,0
1972,India,0,0,1,1
1972,Indonesia,0,0,0,0
1972,Iran,0,2,1,3
1972,Ireland,0,0,0,0
1972,Israel,0,0,0,0
1972,Italy,5,3,10,18
1972,Jamaica,0,0,1,1
1972,Japan,13,8,8,29
1972,Kenya,2,3,4,9
1972,Kuwait,0,0,0,0
1972,Lebanon,0,1,0,1
1972,Lesotho,0,0,0,0
1972,Liberia,0,0,0,0
1972,Liechtenstein,0,0,0,0
1972,Luxembourg,0,0,0,0
1972,Madagascar,0,0,0,0
1972,Malawi,0,0,0,0
1972,Malaysia,0,0,0,0
1972,Mali,0,0,0,0
1972,Malta,0,0,0,0
1972,Mexico,0,1,0,1
1972,Monaco,0,0,0,0
1972,Mongolia,0,1,0,1
1972,Morocco,0,0,0,0
1972,Myanmar,0,0,0,0
1972,Nepal,0,0,0,0
1972,Netherlands,3,1,1,5
1972,Netherlands Antilles,0,0,0,0
1972,New Zealand,1,1,1,3
1972,Nicaragua,0,0,0,0
1972,Niger,0,0,1,1
1972,Nigeria,0,0,1,1
1972,North Korea,1,1,3,5
1972,Norway,2,1,1,4
1972,Pakistan,0,1,0,1
1972,Panama,0,0,0,0
1972,Paraguay,0,0,0,0
1972,Peru,0,0,0,0
1972,Philippines,0,0,0,0
1972,Poland,7,5,9,21
1972,Poland-1,0,0,0,0
1972,Poland-2,0,0,0,0
1972,Poland-3,0,0,0,0
1972,Portugal,0,0,0,0
1972,Puerto Rico,0,0,0,0
1972,Romania,3,6,7,16
1972,San Marino,0,0,0,0
1972,Saudi Arabia,0,0,0,0
1972,Senegal,0,0,0,0
1972,Singapore,0,0,0,0
1972,Somalia,0,0,0,0
1972,South Korea,0,1,0,1
1972,South Vietnam,0,0,0,0
1972,Soviet Union,50,27,22,99
1972,Spain,0,0,1,1
1972,Sri Lanka,0,0,0,0
1972,Sudan,0,0,0,0
1972,Suriname,0,0,0,0
1972,Swaziland,0,0,0,0
1972,Sweden,4,6,6,16
1972,Switzerland,0,3,0,3
1972,Syria,0,0,0,0
1972,Tanzania,0,0,0,0
1972,Thailand,0,0,0,0
1972,Togo,0,0,0,0
1972,Trinidad and Tobago,0,0,0,0
1972,Tunisia,0,1,0,1
1972,Turkey,0,1,0,1
1972,Uganda,1,1,0,2
1972,United States,33,31,30,94
1972,United States Virgin Islands,0,0,0,0
1972,United States-1,0,0,0,0
1972,United States-2,0,0,0,0
1972,Uruguay,0,0,0,0
1972,Venezuela,0,0,0,0
1972,West Germany,13,10,16,39
1972,West Germany-1,0,1,0,1
1972,West Germany-2,0,0,0,0
1972,West Germany-3,0,0,0,0
1972,Yugoslavia,2,1,2,5
1972,Yugoslavia-1,0,0,0,0
1972,Yugoslavia-2,0,0,0,0
1972,Zambia,0,0,0,0
1976,Andorra,0,0,0,0
1976,Antigua and Barbuda,0,0,0,0
1976,Argentina,0,0,0,0
1976,Australia,0,1,4,5
1976,Austria,0,0,1,1
1976,Bahamas,0,0,0,0
1976,Barbados,0,0,0,0
1976,Belgium,0,3,3,6
1976,Belize,0,0,0,0
1976,Bermuda,0,0,1,1
1976,Bolivia,0,0,0,0
1976,Brazil,0,0,2,2
1976,Bulgaria,6,9,7,22
1976,Cameroon,0,0,0,0
1976,Canada,0,5,6,11
1976,Cayman Islands,0,0,0,0
1976,Chile,0,0,0,0
1976,Colombia,0,0,0,0
1976,Costa Rica,0,0,0,0
1976,Cote d'Ivoire,0,0,0,0
1976,Cuba,6,4,3,13
1976,Czechoslovakia,2,2,4,8
1976,Denmark,1,0,2,3
1976,Dominican Republic,0,0,0,0
1976,East Germany,40,25,25,90
1976,Ecuador,0,0,0,0
1976,Egypt,0,0,0,0
1976,Fiji,0,0,0,0
1976,Finland,4,2,0,6
1976,France,2,3,4,9
1976,Great Britain,3,5,5,13
1976,Greece,0,0,0,0
1976,Guatemala,0,0,0,0
1976,Haiti,0,0,0,0
1976,Honduras,0,0,0,0
1976,Hong Kong,0,0,0,0
1976,Hungary,4,5,13,22
1976,Iceland,0,0,0,0
1976,India,0,0,0,0
1976,Indonesia,0,0,0,0
1976,Iran,0,1,1,2
1976,Ireland,0,0,0,0
1976,Israel,0,0,0,0
1976,Italy,2,7,4,13
1976,Jamaica,1,1,0,2
1976,Japan,9,6,10,25
1976,Kuwait,0,0,0,0
1976,Lebanon,0,0,0,0
1976,Liechtenstein,0,0,0,0
1976,Luxembourg,0,0,0,0
1976,Malaysia,0,0,0,0
1976,Mexico,1,0,1,2
1976,Monaco,0,0,0,0
1976,Mongolia,0,1,0,1
1976,Morocco,0,0,0,0
1976,Nepal,0,0,0,0
1976,Netherlands,0,2,3,5
1976,Netherlands Antilles,0,0,0,0
1976,New Zealand,2,1,1,4
1976,Nicaragua,0,0,0,0
1976,North Korea,1,1,0,2
1976,Norway,1,1,0,2
1976,Pakistan,0,0,1,1
1976,Panama,0,0,0,0
1976,Papua New Guinea,0,0,0,0
1976,Paraguay,0,0,0,0
1976,Peru,0,0,0,0
1976,Philippines,0,0,0,0
1976,Poland,7,6,13,26
1976,Portugal,0,2,0,2
1976,Puerto Rico,0,0,1,1
1976,Romania,4,9,14,27
1976,San Marino,0,0,0,0
1976,Saudi Arabia,0,0,0,0
1976,Senegal,0,0,0,0
1976,Singapore,0,0,0,0
1976,South Korea,1,1,4,6
1976,Soviet Union,49,41,35,125
1976,Spain,0,2,0,2
1976,Suriname,0,0,0,0
1976,Sweden,4,1,0,5
1976,Switzerland,1,1,2,4
1976,Thailand,0,0,1,1
1976,Trinidad and Tobago,1,0,0,1
1976,Tunisia,0,0,0,0
1976,Turkey,0,0,0,0
1976,United States,34,35,25,94
1976,United States Virgin Islands,0,0,0,0
1976,Uruguay,0,0,0,0
1976,Venezuela,0,1,0,1
1976,West Germany,10,12,17,39
1976,Yugoslavia,2,3,3,8
1980,Afghanistan,0,0,0,0
1980,Algeria,0,0,0,0
1980,Andorra,0,0,0,0
1980,Angola,0,0,0,0
1980,Australia,2,2,5,9
1980,Austria,1,2,1,4
1980,Belgium,1,0,0,1
1980,Benin,0,0,0,0
1980,Botswana,0,0,0,0
1980,Brazil,2,0,2,4
1980,Bulgaria,8,16,17,41
1980,Cameroon,0,0,0,0
1980,Colombia,0,0,0,0
1980,Congo (Brazzaville),0,0,0,0
1980,Costa Rica,0,0,0,0
1980,Cuba,8,7,5,20
1980,Cyprus,0,0,0,0
1980,Czechoslovakia,2,3,9,14
1980,Denmark,2,1,2,5
1980,Dominican Republic,0,0,0,0
1980,East Germany,47,37,42,126
1980,Ecuador,0,0,0,0
1980,Ethiopia,2,0,2,4
1980,Finland,3,1,4,8
1980,France,6,5,3,14
1980,Great Britain,5,7,9,21
1980,Greece,1,0,2,3
1980,Guatemala,0,0,0,0
1980,Guinea,0,0,0,0
1980,Guyana,0,0,1,1
1980,Hungary,7,10,15,32
1980,Iceland,0,0,0,0
1980,India,1,0,0,1
1980,Iraq,0,0,0,0
1980,Ireland,0,1,1,2
1980,Italy,8,3,4,15
1980,Jamaica,0,0,3,3
1980,Jordan,0,0,0,0
1980,Kuwait,0,0,0,0
1980,Laos,0,0,0,0
1980,Lebanon,0,0,1,1
1980,Lesotho,0,0,0,0
1980,Libya,0,0,0,0
1980,Luxembourg,0,0,0,0
1980,Madagascar,0,0,0,0
1980,Mali,0,0,0,0
1980,Malta,0,0,0,0
1980,Mexico,0,1,3,4
1980,Mongolia,0,2,2,4
1980,Mozambique,0,0,0,0
1980,Myanmar,0,0,0,0
1980,Nepal,0,0,0,0
1980,Netherlands,0,1,2,3
1980,New Zealand,0,0,0,0
1980,Nicaragua,0,0,0,0
1980,Nigeria,0,0,0,0
1980,North Korea,0,3,2,5
1980,Peru,0,0,0,0
1980,Poland,3,14,15,32
1980,Portugal,0,0,0,0
1980,Puerto Rico,0,0,0,0
1980,Romania,6,6,13,25
1980,San Marino,0,0,0,0
1980,Senegal,0,0,0,0
1980,Seychelles,0,0,0,0
1980,Sierra Leone,0,0,0,0
1980,Soviet Union,80,69,46,195
1980,Spain,1,3,2,6
1980,Sri Lanka,0,0,0,0
1980,Sweden,3,3,6,12
1980,Switzerland,2,0,0,2
1980,Syria,0,0,0,0
1980,Tanzania,0,2,0,2
1980,Trinidad and Tobago,0,0,0,0
1980,Uganda,0,1,0,1
1980,Venezuela,0,1,0,1
1980,Vietnam,0,0,0,0
1980,Yugoslavia,2,3,4,9
1980,Zambia,0,0,0,0
1980,Zimbabwe,1,0,0,1
1984,Algeria,0,0,2,2
1984,Andorra,0,0,0,0
1984,Antigua and Barbuda,0,0,0,0
1984,Argentina,0,0,0,0
1984,Australia,4,8,12,24
1984,Austria,1,1,1,3
1984,Bahamas,0,0,0,0
1984,Bahrain,0,0,0,0
1984,Bangladesh,0,0,0,0
1984,Barbados,0,0,0,0
1984,Belgium,1,1,2,4
1984,Belize,0,0,0,0
1984,Benin,0,0,0,0
1984,Bermuda,0,0,0,0
1984,Bhutan,0,0,0,0
1984,Bolivia,0,0,0,0
1984,Botswana,0,0,0,0
1984,Brazil,1,5,2,8
1984,British Virgin Islands,0,0,0,0
1984,Cameroon,0,0,1,1
1984,Canada,10,18,16,44
1984,Cayman Islands,0,0,0,0
1984,Central African Republic,0,0,0,0
1984,Chad,0,0,0,0
1984,Chile,0,0,0,0
1984,China,15,8,9,32
1984,Chinese Taipei,0,0,1,1
1984,Colombia,0,1,0,1
1984,Congo (Brazzaville),0,0,0,0
1984,Congo (Kinshasa),0,0,0,0
1984,Costa Rica,0,0,0,0
1984,Cote d'Ivoire,0,1,0,1
1984,Cyprus,0,0,0,0
1984,Denmark,0,3,3,6
1984,Djibouti,0,0,0,0
1984,Dominican Republic,0,0,1,1
1984,Ecuador,0,0,0,0
1984,Egypt,0,1,0,1
1984,El Salvador,0,0,0,0
1984,Equatorial Guinea,0,0,0,0
1984,Fiji,0,0,0,0
1984,Finland,4,2,6,12
1984,France,5,7,16,28
1984,Gabon,0,0,0,0
1984,Gambia,0,0,0,0
1984,Ghana,0,0,0,0
1984,Great Britain,5,11,21,37
1984,Greece,0,1,1,2
1984,Grenada,0,0,0,0
1984,Guatemala,0,0,0,0
1984,Guinea,0,0,0,0
1984,Guyana,0,0,0,0
1984,Haiti,0,0,0,0
1984,Honduras,0,0,0,0
1984,Hong Kong,0,0,0,0
1984,Iceland,0,0,1,1
1984,India,0,0,0,0
1984,Indonesia,0,0,0,0
1984,Iraq,0,0,0,0
1984,Ireland,0,1,0,1
1984,Israel,0,0,0,0
1984,Italy,14,6,12,32
1984,Jamaica,0,1,2,3
1984,Japan,10,7,14,31
1984,Jordan,0,0,0,0
1984,Kenya,1,0,2,3
1984,Kuwait,0,0,0,0
1984,Lebanon,0,0,0,0
1984,Lesotho,0,0,0,0
1984,Liberia,0,0,0,0
1984,Liechtenstein,0,0,0,0
1984,Luxembourg,0,0,0,0
1984,Madagascar,0,0,0,0
1984,Malawi,0,0,0,0
1984,Malaysia,0,0,0,0
1984,Mali,0,0,0,0
1984,Malta,0,0,0,0
1984,Mauritania,0,0,0,0
1984,Mauritius,0,0,0,0
1984,Mexico,2,3,1,6
1984,Monaco,0,0,0,0
1984,Morocco,2,0,0,2
1984,Mozambique,0,0,0,0
1984,Myanmar,0,0,0,0
1984,Nepal,0,0,0,0
1984,Netherlands,5,2,6,13
1984,Netherlands Antilles,0,0,0,0
1984,New Zealand,8,1,2,11
1984,Nicaragua,0,0,0,0
1984,Niger,0,0,0,0
1984,Nigeria,0,1,1,2
1984,North Yemen,0,0,0,0
1984,Norway,0,1,2,3
1984,Oman,0,0,0,0
1984,Pakistan,1,0,0,1
1984,Panama,0,0,0,0
1984,Papua New Guinea,0,0,0,0
1984,Paraguay,0,0,0,0
1984,Peru,0,1,0,1
1984,Philippines,0,0,0,0
1984,Portugal,1,0,2,3
1984,Puerto Rico,0,1,1,2
1984,Qatar,0,0,0,0
1984,Romania,19,16,17,52
1984,Rwanda,0,0,0,0
1984,Samoa,0,0,0,0
1984,San Marino,0,0,0,0
1984,Saudi Arabia,0,0,0,0
1984,Senegal,0,0,0,0
1984,Seychelles,0,0,0,0
1984,Sierra Leone,0,0,0,0
1984,Singapore,0,0,0,0
1984,Solomon Islands,0,0,0,0
1984,Somalia,0,0,0,0
1984,South Korea,6,6,7,19
1984,Spain,1,2,2,5
1984,Sri Lanka,0,0,0,0
1984,Sudan,0,0,0,0
1984,Suriname,0,0,0,0
1984,Swaziland,0,0,0,0
1984,Sweden,2,11,6,19
1984,Switzerland,0,4,4,8
1984,Syria,0,1,0,1
1984,Tanzania,0,0,0,0
1984,Thailand,0,1,0,1
1984,Togo,0,0,0,0
1984,Tonga,0,0,0,0
1984,Trinidad and Tobago,0,0,0,0
1984,Tunisia,0,0,0,0
1984,Turkey,0,0,3,3
1984,Uganda,0,0,0,0
1984,United Arab Emirates,0,0,0,0
1984,United States,82,61,30,173
1984,United States Virgin Islands,0,0,0,0
1984,Uruguay,0,0,0,0
1984,Venezuela,0,0,3,3
1984,West Germany,17,19,23,59
1984,Yugoslavia,7,4,7,18
1984,Zambia,0,0,1,1
1984,Zimbabwe,0,0,0,0
1988,Afghanistan,0,0,0,0
1988,Algeria,0,0,0,0
1988,American Samoa,0,0,0,0
1988,Andorra,0,0,0,0
1988,Angola,0,0,0,0
1988,Antigua and Barbuda,0,0,0,0
1988,Argentina,0,1,1,2
1988,Aruba,0,0,0,0
1988,Australia,3,6,5,14
1988,Austria,1,0,0,1
1988,Bahamas,0,0,0,0
1988,Bahrain,0,0,0,0
1988,Bangladesh,0,0,0,0
1988,Barbados,0,0,0,0
1988,Belgium,0,0,2,2
1988,Belize,0,0,0,0
1988,Benin,0,0,0,0
1988,Bermuda,0,0,0,0
1988,Bhutan,0,0,0,0
1988,Bolivia,0,0,0,0
1988,Botswana,0,0,0,0
1988,Brazil,1,2,3,6
1988,British Virgin Islands,0,0,0,0
1988,Bulgaria,10,12,13,35
1988,Burkina Faso,0,0,0,0
1988,Cameroon,0,0,0,0
1988,Canada,3,2,5,10
1988,Cayman Islands,0,0,0,0
1988,Central African Republic,0,0,0,0
1988,Chad,0,0,0,0
1988,Chile,0,1,0,1
1988,China,4,11,12,27
1988,China-1,1,0,0,1
1988,China-2,0,0,0,0
1988,Chinese Taipei,0,0,0,0
1988,Chinese Taipei-1,0,0,0,0
1988,Chinese Taipei-2,0,0,0,0
1988,Colombia,0,0,1,1
1988,Congo (Brazzaville),0,0,0,0
1988,Congo (Kinshasa),0,0,0,0
1988,Cook Islands,0,0,0,0
1988,Costa Rica,0,1,0,1
1988,Cote d'Ivoire,0,0,0,0
1988,Cyprus,0,0,0,0
1988,Czechoslovakia,3,3,2,8
1988,Denmark,2,1,1,4
1988,Djibouti,0,0,1,1
1988,Dominican Republic,0,0,0,0
1988,East Germany,37,35,30,102
1988,Ecuador,0,0,0,0
1988,Egypt,0,0,0,0
1988,El Salvador,0,0,0,0
1988,Equatorial Guinea,0,0,0,0
1988,Fiji,0,0,0,0
1988,Finland,1,1,2,4
1988,France,6,4,6,16
1988,Gabon,0,0,0,0
1988,Gambia,0,0,0,0
1988,Ghana,0,0,0,0
1988,Great Britain,5,10,9,24
1988,Great Britain-1,0,0,0,0
1988,Great Britain-2,0,0,0,0
1988,Greece,0,0,1,1
1988,Grenada,0,0,0,0
1988,Guam,0,0,0,0
1988,Guatemala,0,0,0,0
1988,Guinea,0,0,0,0
1988,Guyana,0,0,0,0
1988,Haiti,0,0,0,0
1988,Honduras,0,0,0,0
1988,Hong Kong,0,0,0,0
1988,Hong Kong-1,0,0,0,0
1988,Hong Kong-2,0,0,0,0
1988,Hungary,11,6,6,23
1988,Iceland,0,0,0,0
1988,India,0,0,0,0
1988,Indonesia,0,1,0,1
1988,Iran,0,1,0,1
1988,Iraq,0,0,0,0
1988,Ireland,0,0,0,0
1988,Israel,0,0,0,0
1988,Italy,6,4,4,14
1988,Jamaica,0,2,0,2
1988,Japan,4,3,7,14
1988,Japan-1,0,0,0,0
1988,Japan-2,0,0,0,0
1988,Jordan,0,0,0,0
1988,Kenya,5,2,2,9
1988,Kuwait,0,0,0,0
1988,Laos,0,0,0,0
1988,Lebanon,0,0,0,0
1988,Lesotho,0,0,0,0
1988,Liberia,0,0,0,0
1988,Libya,0,0,0,0
1988,Liechtenstein,0,0,0,0
1988,Luxembourg,0,0,0,0
1988,Malawi,0,0,0,0
1988,Malaysia,0,0,0,0
1988,Maldives,0,0,0,0
1988,Mali,0,0,0,0
1988,Malta,0,0,0,0
1988,Mauritania,0,0,0,0
1988,Mauritius,0,0,0,0
1988,Mexico,0,0,2,2
1988,Monaco,0,0,0,0
1988,Mongolia,0,0,1,1
1988,Morocco,1,0,2,3
1988,Mozambique,0,0,0,0
1988,Myanmar,0,0,0,0
1988,Nepal,0,0,0,0
1988,Netherlands,2,2,5,9
1988,Netherlands Antilles,0,1,0,1
1988,New Zealand,3,2,8,13
1988,Niger,0,0,0,0
1988,Nigeria,0,0,0,0
1988,Nigeria-1,0,0,0,0
1988,Nigeria-2,0,0,0,0
1988,North Yemen,0,0,0,0
1988,Norway,2,3,0,5
1988,Oman,0,0,0,0
1988,Pakistan,0,0,1,1
1988,Panama,0,0,0,0
1988,Papua New Guinea,0,0,0,0
1988,Paraguay,0,0,0,0
1988,Peru,0,1,0,1
1988,Philippines,0,0,1,1
1988,Poland,2,5,9,16
1988,Portugal,1,0,0,1
1988,Puerto Rico,0,0,0,0
1988,Qatar,0,0,0,0
1988,Romania,7,11,6,24
1988,Rwanda,0,0,0,0
1988,Saint Vincent and the Grenadines,0,0,0,0
1988,Samoa,0,0,0,0
1988,San Marino,0,0,0,0
1988,Saudi Arabia,0,0,0,0
1988,Senegal,0,1,0,1
1988,Sierra Leone,0,0,0,0
1988,Singapore,0,0,0,0
1988,Solomon Islands,0,0,0,0
1988,Somalia,0,0,0,0
1988,South Korea,12,10,10,32
1988,South Korea-1,0,0,0,0
1988,South Korea-2,0,0,1,1
1988,South Yemen,0,0,0,0
1988,Soviet Union,54,31,46,131
1988,Spain,1,1,2,4
1988,Sri Lanka,0,0,0,0
1988,Sudan,0,0,0,0
1988,Suriname,1,0,0,1
1988,Swaziland,0,0,0,0
1988,Sweden,0,4,7,11
1988,Sweden-1,0,0,0,0
1988,Sweden-2,0,0,0,0
1988,Switzerland,0,2,2,4
1988,Syria,0,0,0,0
1988,Tanzania,0,0,0,0
1988,Thailand,0,0,1,1
1988,Togo,0,0,0,0
1988,Tonga,0,0,0,0
1988,Trinidad and Tobago,0,0,0,0
1988,Tunisia,0,0,0,0
1988,Turkey,1,1,0,2
1988,Uganda,0,0,0,0
1988,United Arab Emirates,0,0,0,0
1988,United States,36,31,27,94
1988,United States Virgin Islands,0,1,0,1
1988,Uruguay,0,0,0,0
1988,Vanuatu,0,0,0,0
1988,Venezuela,0,0,0,0
1988,Vietnam,0,0,0,0
1988,West Germany,11,14,15,40
1988,West Germany-1,0,0,0,0
1988,West Germany-2,0,0,0,0
1988,Yugoslavia,3,4,5,12
1988,Zambia,0,0,0,0
1988,Zimbabwe,0,0,0,0
1992,Albania,0,0,0,0
1992,Algeria,1,0,1,2
1992,American Samoa,0,0,0,0
1992,Andorra,0,0,0,0
1992,Angola,0,0,0,0
1992,Antigua and Barbuda,0,0,0,0
1992,Argentina,0,0,1,1
1992,Aruba,0,0,0,0
1992,Australia,7,9,11,27
1992,Austria,0,2,0,2
1992,Bahamas,0,0,1,1
1992,Bahrain,0,0,0,0
1992,Bangladesh,0,0,0,0
1992,Barbados,0,0,0,0
1992,Belgium,0,1,2,3
1992,Belize,0,0,0,0
1992,Benin,0,0,0,0
1992,Bermuda,0,0,0,0
1992,Bhutan,0,0,0,0
1992,Bolivia,0,0,0,0
1992,Bosnia and Herzegovina,0,0,0,0
1992,Botswana,0,0,0,0
1992,Brazil,2,1,0,3
1992,British Virgin Islands,0,0,0,0
1992,Bulgaria,3,7,6,16
1992,Bulgaria-1,0,0,0,0
1992,Bulgaria-2,0,0,0,0
1992,Burkina Faso,0,0,0,0
1992,Cameroon,0,0,0,0
1992,Canada,7,4,7,18
1992,Canada-1,0,0,0,0
1992,Canada-2,0,0,0,0
1992,Cayman Islands,0,0,0,0
1992,Central African Republic,0,0,0,0
1992,Chad,0,0,0,0
1992,Chile,0,0,0,0
1992,China,14,20,13,47
1992,China-1,1,2,0,3
1992,China-2,1,0,2,3
1992,Chinese Taipei,0,1,0,1
1992,Colombia,0,0,1,1
1992,Congo (Brazzaville),0,0,0,0
1992,Congo (Kinshasa),0,0,0,0
1992,Cook Islands,0,0,0,0
1992,Costa Rica,0,0,0,0
1992,Cote d'Ivoire,0,0,0,0
1992,Croatia,0,1,2,3
1992,Cuba,14,6,11,31
1992,Cyprus,0,0,0,0
1992,Czechoslovakia,4,1,1,6
1992,Czechoslovakia-1,0,1,0,1
1992,Czechoslovakia-2,0,0,0,0
1992,Czechoslovakia-3,0,0,0,0
1992,Denmark,1,1,4,6
1992,Denmark-1,0,0,0,0
1992,Denmark-2,0,0,0,0
1992,Djibouti,0,0,0,0
1992,Dominican Republic,0,0,0,0
1992,Ecuador,0,0,0,0
1992,Egypt,0,0,0,0
1992,El Salvador,0,0,0,0
1992,Equatorial Guinea,0,0,0,0
1992,Estonia,1,0,1,2
1992,Ethiopia,1,0,2,3
1992,Fiji,0,0,0,0
1992,Finland,1,2,2,5
1992,France,8,5,15,28
1992,France-1,0,0,1,1
1992,France-2,0,0,0,0
1992,France-3,0,0,0,0
1992,Gabon,0,0,0,0
1992,Gambia,0,0,0,0
1992,Germany,33,21,28,82
1992,Germany-1,0,0,0,0
1992,Germany-2,0,0,0,0
1992,Germany-3,0,0,0,0
1992,Ghana,0,0,1,1
1992,Great Britain,5,3,12,20
1992,Great Britain-1,0,0,0,0
1992,Great Britain-2,0,0,0,0
1992,Greece,2,0,0,2
1992,Grenada,0,0,0,0
1992,Guam,0,0,0,0
1992,Guatemala,0,0,0,0
1992,Guinea,0,0,0,0
1992,Guyana,0,0,0,0
1992,Haiti,0,0,0,0
1992,Honduras,0,0,0,0
1992,Hong Kong,0,0,0,0
1992,Hungary,11,12,7,30
1992,Iceland,0,0,0,0
1992,India,0,0,0,0
1992,Individual Olympic Athletes,0,1,2,3
1992,Indonesia,2,1,1,4
1992,Indonesia-1,0,1,0,1
1992,Indonesia-2,0,0,0,0
1992,Iran,0,1,2,3
1992,Iraq,0,0,0,0
1992,Ireland,1,1,0,2
1992,Israel,0,1,1,2
1992,Italy,6,5,8,19
1992,Jamaica,0,3,1,4
1992,Japan,3,8,11,22
1992,Japan-1,0,0,0,0
1992,Japan-2,0,0,0,0
1992,Japan-3,0,0,0,0
1992,Jordan,0,0,0,0
1992,Kenya,2,4,2,8
1992,Kuwait,0,0,0,0
1992,Laos,0,0,0,0
1992,Latvia,0,2,1,3
1992,Lebanon,0,0,0,0
1992,Lesotho,0,0,0,0
1992,Libya,0,0,0,0
1992,Liechtenstein,0,0,0,0
1992,Lithuania,1,0,1,2
1992,Luxembourg,0,0,0,0
1992,Madagascar,0,0,0,0
1992,Malawi,0,0,0,0
1992,Malaysia,0,0,0,0
1992,Malaysia-1,0,0,0,0
1992,Malaysia-2,0,0,1,1
1992,Maldives,0,0,0,0
1992,Mali,0,0,0,0
1992,Malta,0,0,0,0
1992,Mauritania,0,0,0,0
1992,Mauritius,0,0,0,0
1992,Mexico,0,1,0,1
1992,Monaco,0,0,0,0
1992,Mongolia,0,0,2,2
1992,Morocco,1,1,1,3
1992,Mozambique,0,0,0,0
1992,Myanmar,0,0,0,0
1992,Namibia,0,2,0,2
1992,Nepal,0,0,0,0
1992,Netherlands,2,6,7,15
1992,Netherlands Antilles,0,0,0,0
1992,New Zealand,1,4,5,10
1992,Nicaragua,0,0,0,0
1992,Niger,0,0,0,0
1992,Nigeria,0,3,1,4
1992,Nigeria-1,0,0,0,0
1992,Nigeria-2,0,0,0,0
1992,North Korea,4,0,4,8
1992,North Korea-1,0,0,1,1
1992,North Korea-2,0,0,0,0
1992,Norway,2,4,1,7
1992,Oman,0,0,0,0
1992,Pakistan,0,0,1,1
1992,Panama,0,0,0,0
1992,Papua New Guinea,0,0,0,0
1992,Paraguay,0,0,0,0
1992,Peru,0,1,0,1
1992,Philippines,0,0,1,1
1992,Poland,3,6,10,19
1992,Poland-1,0,0,0,0
1992,Poland-2,0,0,0,0
1992,Portugal,0,0,0,0
1992,Puerto Rico,0,0,1,1
1992,Qatar,0,0,1,1
1992,Romania,4,6,8,18
1992,Romania-1,0,0,0,0
1992,Romania-2,0,0,0,0
1992,Rwanda,0,0,0,0
1992,Saint Vincent and the Grenadines,0,0,0,0
1992,Samoa,0,0,0,0
1992,San Marino,0,0,0,0
1992,Saudi Arabia,0,0,0,0
1992,Senegal,0,0,0,0
1992,Seychelles,0,0,0,0
1992,Sierra Leone,0,0,0,0
1992,Singapore,0,0,0,0
1992,Slovenia,0,0,2,2
1992,Solomon Islands,0,0,0,0
1992,South Africa,0,2,0,2
1992,South Korea,10,5,8,23
1992,South Korea-1,1,0,3,4
1992,South Korea-2,1,0,1,2
1992,Spain,13,7,2,22
1992,Sri Lanka,0,0,0,0
1992,Sudan,0,0,0,0
1992,Suriname,0,0,1,1
1992,Swaziland,0,0,0,0
1992,Sweden,1,7,4,12
1992,Sweden-1,0,0,0,0
1992,Sweden-2,0,0,0,0
1992,Switzerland,1,0,0,1
1992,Syria,0,0,0,0
1992,Tanzania,0,0,0,0
1992,Thailand,0,0,1,1
1992,Togo,0,0,0,0
1992,Tonga,0,0,0,0
1992,Trinidad and Tobago,0,0,0,0
1992,Tunisia,0,0,0,0
1992,Turkey,2,2,2,6
1992,Uganda,0,0,0,0
1992,Unified Team,45,38,29,112
1992,Unified Team-1,0,0,0,0
1992,Unified Team-2,0,0,0,0
1992,United Arab Emirates,0,0,0,0
1992,United States,36,34,37,107
1992,United States Virgin Islands,0,0,0,0
1992,United States-1,1,0,0,1
1992,United States-2,0,0,0,0
1992,United States-3,0,0,0,0
1992,Uruguay,0,0,0,0
1992,Vanuatu,0,0,0,0
1992,Venezuela,0,0,0,0
1992,Vietnam,0,0,0,0
1992,Yemen,0,0,0,0
1992,Zambia,0,0,0,0
1992,Zimbabwe,0,0,0,0
1996,Afghanistan,0,0,0,0
1996,Albania,0,0,0,0
1996,Algeria,2,0,1,3
1996,American Samoa,0,0,0,0
1996,Andorra,0,0,0,0
1996,Angola,0,0,0,0
1996,Antigua and Barbuda,0,0,0,0
1996,Argentina,0,2,1,3
1996,Armenia,1,1,0,2
1996,Aruba,0,0,0,0
1996,Australia,9,9,22,40
1996,Australia-1,0,0,1,1
1996,Australia-2,0,0,0,0
1996,Austria,0,1,2,3
1996,Austria-1,0,0,0,0
1996,Austria-2,0,0,0,0
1996,Azerbaijan,0,1,0,1
1996,Bahamas,0,1,0,1
1996,Bahrain,0,0,0,0
1996,Bangladesh,0,0,0,0
1996,Barbados,0,0,0,0
1996,Belarus,1,6,8,15
1996,Belgium,2,2,2,6
1996,Belize,0,0,0,0
1996,Benin,0,0,0,0
1996,Bermuda,0,0,0,0
1996,Bhutan,0,0,0,0
1996,Bolivia,0,0,0,0
1996,Bosnia and Herzegovina,0,0,0,0
1996,Botswana,0,0,0,0
1996,Brazil,2,2,9,13
1996,Brazil-1,1,0,0,1
1996,Brazil-2,0,1,0,1
1996,British Virgin Islands,0,0,0,0
1996,Brunei,0,0,0,0
1996,Bulgaria,3,7,5,15
1996,Burkina Faso,0,0,0,0
1996,Burundi,1,0,0,1
1996,Cambodia,0,0,0,0
1996,Cameroon,0,0,0,0
1996,Canada,3,11,7,21
1996,Canada-1,0,0,1,1
1996,Canada-2,0,0,0,0
1996,Cape Verde,0,0,0,0
1996,Cayman Islands,0,0,0,0
1996,Central African Republic,0,0,0,0
1996,Chad,0,0,0,0
1996,Chile,0,0,0,0
1996,China,13,20,11,44
1996,China-1,1,1,0,2
1996,China-2,2,1,1,4
1996,Chinese Taipei,0,1,0,1
1996,Chinese Taipei-1,0,0,0,0
1996,Chinese Taipei-2,0,0,0,0
1996,Colombia,0,0,0,0
1996,Comoros,0,0,0,0
1996,Congo (Brazzaville),0,0,0,0
1996,Congo (Kinshasa),0,0,0,0
1996,Cook Islands,0,0,0,0
1996,Costa Rica,1,0,0,1
1996,Cote d'Ivoire,0,0,0,0
1996,Croatia,1,1,0,2
1996,Cuba,9,8,8,25
1996,Cyprus,0,0,0,0
1996,Czech Republic,4,2,4,10
1996,Czech Republic-1,0,1,0,1
1996,Czech Republic-2,0,0,0,0
1996,Denmark,4,1,1,6
1996,Denmark-1,0,0,0,0
1996,Denmark-2,0,0,0,0
1996,Djibouti,0,0,0,0
1996,Dominica,0,0,0,0
1996,Dominican Republic,0,0,0,0
1996,Ecuador,1,0,0,1
1996,Egypt,0,0,0,0
1996,El Salvador,0,0,0,0
1996,Equatorial Guinea,0,0,0,0
1996,Estonia,0,0,0,0
1996,Ethiopia,2,0,1,3
1996,Fiji,0,0,0,0
1996,Finland,1,2,1,4
1996,France,14,7,15,36
1996,France-1,1,0,0,1
1996,France-2,0,0,0,0
1996,Gabon,0,0,0,0
1996,Gambia,0,0,0,0
1996,Georgia,0,0,2,2
1996,Germany,20,18,26,64
1996,Germany-1,0,0,1,1
1996,Germany-2,0,0,0,0
1996,Ghana,0,0,0,0
1996,Great Britain,1,8,6,15
1996,Great Britain-1,0,0,0,0
1996,Great Britain-2,0,0,0,0
1996,Greece,4,4,0,8
1996,Grenada,0,0,0,0
1996,Guam,0,0,0,0
1996,Guatemala,0,0,0,0
1996,Guinea,0,0,0,0
1996,Guinea Bissau,0,0,0,0
1996,Guyana,0,0,0,0
1996,Haiti,0,0,0,0
1996,Honduras,0,0,0,0
1996,Hong Kong,1,0,0,1
1996,Hungary,7,4,10,21
1996,Iceland,0,0,0,0
1996,India,0,0,1,1
1996,Indonesia,1,1,1,3
1996,Indonesia-1,0,0,1,1
1996,Indonesia-2,0,0,0,0
1996,Iran,1,1,1,3
1996,Iraq,0,0,0,0
1996,Ireland,3,0,1,4
1996,Israel,0,0,1,1
1996,Italy,13,10,12,35
1996,Jamaica,1,3,2,6
1996,Japan,3,6,5,14
1996,Japan-1,0,0,0,0
1996,Japan-2,0,0,0,0
1996,Jordan,0,0,0,0
1996,Kazakhstan,3,4,4,11
1996,Kenya,1,4,3,8
1996,Kuwait,0,0,0,0
1996,Kyrgyzstan,0,0,0,0
1996,Laos,0,0,0,0
1996,Latvia,0,1,0,1
1996,Lebanon,0,0,0,0
1996,Lesotho,0,0,0,0
1996,Liberia,0,0,0,0
1996,Libya,0,0,0,0
1996,Liechtenstein,0,0,0,0
1996,Lithuania,0,0,1,1
1996,Luxembourg,0,0,0,0
1996,Macedonia,0,0,0,0
1996,Madagascar,0,0,0,0
1996,Malawi,0,0,0,0
1996,Malaysia,0,0,1,1
1996,Malaysia-1,0,1,0,1
1996,Malaysia-2,0,0,0,0
1996,Maldives,0,0,0,0
1996,Mali,0,0,0,0
1996,Malta,0,0,0,0
1996,Mauritania,0,0,0,0
1996,Mauritius,0,0,0,0
1996,Mauritius-1,0,0,0,0
1996,Mauritius-2,0,0,0,0
1996,Mexico,0,0,1,1
1996,Moldova,0,1,1,2
1996,Monaco,0,0,0,0
1996,Mongolia,0,0,1,1
1996,Morocco,0,0,2,2
1996,Mozambique,0,0,1,1
1996,Myanmar,0,0,0,0
1996,Namibia,0,2,0,2
1996,Nauru,0,0,0,0
1996,Nepal,0,0,0,0
1996,Netherlands,4,5,10,19
1996,Netherlands Antilles,0,0,0,0
1996,Netherlands-1,0,0,0,0
1996,Netherlands-2,0,0,0,0
1996,New Zealand,3,2,1,6
1996,Nicaragua,0,0,0,0
1996,Niger,0,0,0,0
1996,Nigeria,2,1,3,6
1996,North Korea,2,1,2,5
1996,North Korea-1,0,0,0,0
1996,North Korea-2,0,0,0,0
1996,Norway,2,2,3,7
1996,Oman,0,0,0,0
1996,Pakistan,0,0,0,0
1996,Palestine,0,0,0,0
1996,Panama,0,0,0,0
1996,Papua New Guinea,0,0,0,0
1996,Paraguay,0,0,0,0
1996,Peru,0,0,0,0
1996,Philippines,0,1,0,1
1996,Poland,7,5,5,17
1996,Poland-1,0,0,0,0
1996,Poland-2,0,0,0,0
1996,Portugal,1,0,1,2
1996,Puerto Rico,0,0,1,1
1996,Qatar,0,0,0,0
1996,Romania,4,7,8,19
1996,Russia,26,21,16,63
1996,Rwanda,0,0,0,0
1996,Saint Kitts and Nevis,0,0,0,0
1996,Saint Lucia,0,0,0,0
1996,Saint Vincent and the Grenadines,0,0,0,0
1996,Samoa,0,0,0,0
1996,San Marino,0,0,0,0
1996,Sao Tome and Principe,0,0,0,0
1996,Saudi Arabia,0,0,0,0
1996,Senegal,0,0,0,0
1996,Serbia and Montenegro,1,1,2,4
1996,Seychelles,0,0,0,0
1996,Sierra Leone,0,0,0,0
1996,Singapore,0,0,0,0
1996,Slovakia,1,1,1,3
1996,Slovakia-1,0,0,0,0
1996,Slovakia-2,0,0,0,0
1996,Slovenia,0,2,0,2
1996,Solomon Islands,0,0,0,0
1996,Somalia,0,0,0,0
1996,South Africa,3,1,1,5
1996,South Korea,6,13,3,22
1996,South Korea-1,1,0,1,2
1996,South Korea-2,0,2,1,3
1996,Spain,5,6,6,17
1996,Spain-1,0,0,0,0
1996,Spain-2,0,0,0,0
1996,Sri Lanka,0,0,0,0
1996,Sudan,0,0,0,0
1996,Suriname,0,0,0,0
1996,Swaziland,0,0,0,0
1996,Sweden,2,4,2,8
1996,Sweden-1,0,0,0,0
1996,Sweden-2,0,0,0,0
1996,Switzerland,4,3,0,7
1996,Syria,1,0,0,1
1996,Tajikistan,0,0,0,0
1996,Tanzania,0,0,0,0
1996,Thailand,1,0,1,2
1996,Thailand-1,0,0,0,0
1996,Thailand-2,0,0,0,0
1996,Togo,0,0,0,0
1996,Tonga,0,1,0,1
1996,Trinidad and Tobago,0,0,2,2
1996,Tunisia,0,0,1,1
1996,Turkey,4,1,1,6
1996,Turkmenistan,0,0,0,0
1996,Uganda,0,0,1,1
1996,Ukraine,9,2,12,23
1996,United Arab Emirates,0,0,0,0
1996,United States,43,31,25,99
1996,United States Virgin Islands,0,0,0,0
1996,United States-1,1,0,0,1
1996,United States-2,0,1,0,1
1996,United States-3,0,0,0,0
1996,Uruguay,0,0,0,0
1996,Uzbekistan,0,1,1,2
1996,Vanuatu,0,0,0,0
1996,Venezuela,0,0,0,0
1996,Vietnam,0,0,0,0
1996,Yemen,0,0,0,0
1996,Zambia,0,1,0,1
1996,Zimbabwe,0,0,0,0
2000,Albania,0,0,0,0
2000,Algeria,1,1,3,5
2000,American Samoa,0,0,0,0
2000,Andorra,0,0,0,0
2000,Angola,0,0,0,0
2000,Antigua and Barbuda,0,0,0,0
2000,Argentina,0,2,2,4
2000,Argentina-1,0,0,0,0
2000,Argentina-2,0,0,0,0
2000,Armenia,0,0,1,1
2000,Aruba,0,0,0,0
2000,Australia,15,25,17,57
2000,Australia-1,1,0,0,1
2000,Australia-2,0,0,0,0
2000,Australia-3,0,0,0,0
2000,Austria,2,1,0,3
2000,Azerbaijan,2,0,1,3
2000,Bahamas,2,0,1,3
2000,Bahrain,0,0,0,0
2000,Bangladesh,0,0,0,0
2000,Barbados,0,0,1,1
2000,Belarus,3,3,11,17
2000,Belgium,0,2,3,5
2000,Belize,0,0,0,0
2000,Benin,0,0,0,0
2000,Bermuda,0,0,0,0
2000,Bhutan,0,0,0,0
2000,Bolivia,0,0,0,0
2000,Bosnia and Herzegovina,0,0,0,0
2000,Botswana,0,0,0,0
2000,Brazil,0,4,5,9
2000,Brazil-1,0,2,0,2
2000,Brazil-2,0,0,1,1
2000,British Virgin Islands,0,0,0,0
2000,Brunei,0,0,0,0
2000,Bulgaria,5,6,2,13
2000,Burkina Faso,0,0,0,0
2000,Burundi,0,0,0,0
2000,Cambodia,0,0,0,0
2000,Cameroon,1,0,0,1
2000,Canada,3,3,8,14
2000,Canada-1,0,0,0,0
2000,Canada-2,0,0,0,0
2000,Cape Verde,0,0,0,0
2000,Cayman Islands,0,0,0,0
2000,Central African Republic,0,0,0,0
2000,Chad,0,0,0,0
2000,Chile,0,0,1,1
2000,China,24,14,13,51
2000,China-1,1,1,1,3
2000,China-2,3,1,0,4
2000,Chinese Taipei,0,1,4,5
2000,Chinese Taipei-1,0,0,0,0
2000,Chinese Taipei-2,0,0,0,0
2000,Colombia,1,0,0,1
2000,Comoros,0,0,0,0
2000,Congo (Brazzaville),0,0,0,0
2000,Congo (Kinshasa),0,0,0,0
2000,Cook Islands,0,0,0,0
2000,Costa Rica,0,0,2,2
2000,Cote d'Ivoire,0,0,0,0
2000,Croatia,1,0,1,2
2000,Cuba,11,11,7,29
2000,Cyprus,0,0,0,0
2000,Czech Republic,2,3,2,7
2000,Czech Republic-1,0,0,1,1
2000,Czech Republic-2,0,0,0,0
2000,Denmark,2,3,1,6
2000,Denmark-1,0,0,0,0
2000,Denmark-2,0,0,0,0
2000,Djibouti,0,0,0,0
2000,Dominica,0,0,0,0
2000,Dominican Republic,0,0,0,0
2000,Ecuador,0,0,0,0
2000,Egypt,0,0,0,0
2000,El Salvador,0,0,0,0
2000,Equatorial Guinea,0,0,0,0
2000,Eritrea,0,0,0,0
2000,Estonia,1,0,2,3
2000,Ethiopia,4,1,3,8
2000,Federated States of Micronesia,0,0,0,0
2000,Fiji,0,0,0,0
2000,Finland,2,1,1,4
2000,France,13,14,10,37
2000,France-1,0,0,1,1
2000,France-2,0,0,0,0
2000,Gabon,0,0,0,0
2000,Gambia,0,0,0,0
2000,Georgia,0,0,6,6
2000,Germany,13,17,25,55
2000,Germany-1,0,0,1,1
2000,Germany-2,0,0,0,0
2000,Ghana,0,0,0,0
2000,Great Britain,11,10,6,27
2000,Great Britain-1,0,0,0,0
2000,Great Britain-2,0,0,1,1
2000,Greece,4,6,3,13
2000,Grenada,0,0,0,0
2000,Guam,0,0,0,0
2000,Guatemala,0,0,0,0
2000,Guinea,0,0,0,0
2000,Guinea Bissau,0,0,0,0
2000,Guyana,0,0,0,0
2000,Haiti,0,0,0,0
2000,Honduras,0,0,0,0
2000,Hong Kong,0,0,0,0
2000,Hungary,8,6,3,17
2000,Iceland,0,0,1,1
2000,India,0,0,1,1
2000,Individual Olympic Athletes,0,0,0,0
2000,Indonesia,1,2,2,5
2000,Indonesia-1,0,1,0,1
2000,Indonesia-2,0,0,0,0
2000,Iran,3,0,1,4
2000,Iraq,0,0,0,0
2000,Ireland,0,1,0,1
2000,Israel,0,0,1,1
2000,Italy,13,8,13,34
2000,Italy-1,0,0,0,0
2000,Italy-2,0,0,0,0
2000,Jamaica,0,6,3,9
2000,Japan,5,8,5,18
2000,Japan-1,0,0,0,0
2000,Japan-2,0,0,0,0
2000,Jordan,0,0,0,0
2000,Kazakhstan,3,4,0,7
2000,Kenya,2,3,2,7
2000,Kuwait,0,0,1,1
2000,Kyrgyzstan,0,0,1,1
2000,Laos,0,0,0,0
2000,Latvia,1,1,1,3
2000,Lebanon,0,0,0,0
2000,Lesotho,0,0,0,0
2000,Liberia,0,0,0,0
2000,Libya,0,0,0,0
2000,Liechtenstein,0,0,0,0
2000,Lithuania,2,0,3,5
2000,Luxembourg,0,0,0,0
2000,Macedonia,0,0,1,1
2000,Madagascar,0,0,0,0
2000,Malawi,0,0,0,0
2000,Malaysia,0,0,0,0
2000,Malaysia-1,0,0,0,0
2000,Malaysia-2,0,0,0,0
2000,Maldives,0,0,0,0
2000,Mali,0,0,0,0
2000,Malta,0,0,0,0
2000,Mauritania,0,0,0,0
2000,Mauritius,0,0,0,0
2000,Mexico,1,2,3,6
2000,Moldova,0,1,1,2
2000,Monaco,0,0,0,0
2000,Mongolia,0,0,0,0
2000,Morocco,0,1,4,5
2000,Mozambique,1,0,0,1
2000,Myanmar,0,0,0,0
2000,Namibia,0,0,0,0
2000,Nauru,0,0,0,0
2000,Nepal,0,0,0,0
2000,Netherlands,12,9,4,25
2000,Netherlands Antilles,0,0,0,0
2000,New Zealand,1,0,3,4
2000,Nicaragua,0,0,0,0
2000,Niger,0,0,0,0
2000,Nigeria,1,2,0,3
2000,Nigeria-1,0,0,0,0
2000,Nigeria-2,0,0,0,0
2000,North Korea,0,1,3,4
2000,Norway,4,3,3,10
2000,Norway-1,0,0,0,0
2000,Norway-2,0,0,0,0
2000,Oman,0,0,0,0
2000,Pakistan,0,0,0,0
2000,Palau,0,0,0,0
2000,Palestine,0,0,0,0
2000,Panama,0,0,0,0
2000,Papua New Guinea,0,0,0,0
2000,Paraguay,0,0,0,0
2000,Peru,0,0,0,0
2000,Philippines,0,0,0,0
2000,Poland,6,4,3,13
2000,Poland-1,0,1,0,1
2000,Poland-2,0,0,0,0
2000,Portugal,0,0,2,2
2000,Puerto Rico,0,0,0,0
2000,Qatar,0,0,1,1
2000,Romania,11,6,9,26
2000,Russia,32,28,29,89
2000,Rwanda,0,0,0,0
2000,Saint Kitts and Nevis,0,0,0,0
2000,Saint Lucia,0,0,0,0
2000,Saint Vincent and the Grenadines,0,0,0,0
2000,Samoa,0,0,0,0
2000,San Marino,0,0,0,0
2000,Sao Tome and Principe,0,0,0,0
2000,Saudi Arabia,0,1,1,2
2000,Senegal,0,0,0,0
2000,Serbia and Montenegro,1,1,1,3
2000,Seychelles,0,0,0,0
2000,Sierra Leone,0,0,0,0
2000,Singapore,0,0,0,0
2000,Slovakia,1,3,1,5
2000,Slovenia,2,0,0,2
2000,Solomon Islands,0,0,0,0
2000,Somalia,0,0,0,0
2000,South Africa,0,2,3,5
2000,South Korea,8,9,8,25
2000,South Korea-1,0,1,1,2
2000,South Korea-2,0,0,1,1
2000,Spain,3,3,5,11
2000,Sri Lanka,0,1,0,1
2000,Sudan,0,0,0,0
2000,Suriname,0,0,0,0
2000,Swaziland,0,0,0,0
2000,Sweden,4,5,3,12
2000,Sweden-1,0,0,0,0
2000,Sweden-2,0,0,0,0
2000,Switzerland,1,6,2,9
2000,Syria,0,0,0,0
2000,Tajikistan,0,0,0,0
2000,Tanzania,0,0,0,0
2000,Thailand,1,0,2,3
2000,Togo,0,0,0,0
2000,Tonga,0,0,0,0
2000,Trinidad and Tobago,0,1,1,2
2000,Tunisia,0,0,0,0
2000,Turkey,3,0,2,5
2000,Turkmenistan,0,0,0,0
2000,Uganda,0,0,0,0
2000,Ukraine,3,10,10,23
2000,United Arab Emirates,0,0,0,0
2000,United States,35,24,31,90
2000,United States Virgin Islands,0,0,0,0
2000,United States-1,1,0,0,1
2000,United States-2,0,0,0,0
2000,Uruguay,0,1,0,1
2000,Uzbekistan,1,1,2,4
2000,Vanuatu,0,0,0,0
2000,Venezuela,0,0,0,0
2000,Vietnam,0,1,0,1
2000,Yemen,0,0,0,0
2000,Zambia,0,0,0,0
2000,Zimbabwe,0,0,0,0
2004,Afghanistan,0,0,0,0
2004,Albania,0,0,0,0
2004,Algeria,0,0,0,0
2004,American Samoa,0,0,0,0
2004,Andorra,0,0,0,0
2004,Angola,0,0,0,0
2004,Antigua and Barbuda,0,0,0,0
2004,Argentina,2,0,4,6
2004,Argentina-1,0,0,0,0
2004,Argentina-2,0,0,0,0
2004,Armenia,0,0,0,0
2004,Aruba,0,0,0,0
2004,Australia,17,16,17,50
2004,Australia-1,0,0,0,0
2004,Australia-2,0,0,0,0
2004,Austria,2,4,1,7
2004,Austria-1,0,0,0,0
2004,Austria-2,0,0,0,0
2004,Azerbaijan,1,0,4,5
2004,Bahamas,1,0,1,2
2004,Bahrain,0,0,0,0
2004,Bangladesh,0,0,0,0
2004,Barbados,0,0,0,0
2004,Belarus,2,5,6,13
2004,Belgium,1,0,2,3
2004,Belize,0,0,0,0
2004,Benin,0,0,0,0
2004,Bermuda,0,0,0,0
2004,Bhutan,0,0,0,0
2004,Bolivia,0,0,0,0
2004,Bosnia and Herzegovina,0,0,0,0
2004,Botswana,0,0,0,0
2004,Brazil,4,1,3,8
2004,Brazil-1,1,1,0,2
2004,Brazil-2,0,0,0,0
2004,British Virgin Islands,0,0,0,0
2004,Brunei,0,0,0,0
2004,Bulgaria,2,1,9,12
2004,Burkina Faso,0,0,0,0
2004,Burundi,0,0,0,0
2004,Cambodia,0,0,0,0
2004,Cameroon,1,0,0,1
2004,Canada,3,6,3,12
2004,Canada-1,0,0,0,0
2004,Canada-2,0,0,0,0
2004,Cape Verde,0,0,0,0
2004,Cayman Islands,0,0,0,0
2004,Central African Republic,0,0,0,0
2004,Chad,0,0,0,0
2004,Chile,2,0,1,3
2004,China,27,17,13,57
2004,China-1,4,0,0,4
2004,China-2,1,0,1,2
2004,Chinese Taipei,2,2,1,5
2004,Colombia,0,0,2,2
2004,Comoros,0,0,0,0
2004,Congo (Brazzaville),0,0,0,0
2004,Congo (Kinshasa),0,0,0,0
2004,Cook Islands,0,0,0,0
2004,Costa Rica,0,0,0,0
2004,Cote d'Ivoire,0,0,0,0
2004,Croatia,1,2,2,5
2004,Cuba,9,7,11,27
2004,Cyprus,0,0,0,0
2004,Czech Republic,1,3,4,8
2004,Czech Republic-1,0,0,1,1
2004,Czech Republic-2,0,0,0,0
2004,Denmark,2,1,4,7
2004,Denmark-1,0,0,0,0
2004,Denmark-2,0,0,1,1
2004,Dominica,0,0,0,0
2004,Dominican Republic,1,0,0,1
2004,Ecuador,0,0,0,0
2004,Egypt,1,1,3,5
2004,El Salvador,0,0,0,0
2004,Equatorial Guinea,0,0,0,0
2004,Eritrea,0,0,1,1
2004,Estonia,0,1,2,3
2004,Ethiopia,2,3,2,7
2004,Federated States of Micronesia,0,0,0,0
2004,Fiji,0,0,0,0
2004,Finland,0,2,0,2
2004,France,11,9,13,33
2004,France-1,0,0,0,0
2004,France-2,0,0,0,0
2004,Gabon,0,0,0,0
2004,Gambia,0,0,0,0
2004,Georgia,2,2,0,4
2004,Germany,13,15,20,48
2004,Germany-1,0,1,0,1
2004,Germany-2,0,0,0,0
2004,Ghana,0,0,0,0
2004,Great Britain,9,8,12,29
2004,Great Britain-1,0,1,0,1
2004,Great Britain-2,0,0,0,0
2004,Greece,6,6,4,16
2004,Greece-1,0,0,0,0
2004,Greece-2,0,0,0,0
2004,Grenada,0,0,0,0
2004,Guam,0,0,0,0
2004,Guatemala,0,0,0,0
2004,Guinea,0,0,0,0
2004,Guinea Bissau,0,0,0,0
2004,Guyana,0,0,0,0
2004,Haiti,0,0,0,0
2004,Honduras,0,0,0,0
2004,Hong Kong,0,0,0,0
2004,Hong Kong-1,0,0,0,0
2004,Hong Kong-2,0,1,0,1
2004,Hungary,8,6,3,17
2004,Hungary-1,0,0,0,0
2004,Hungary-2,0,0,0,0
2004,Iceland,0,0,0,0
2004,India,0,1,0,1
2004,Indonesia,1,1,1,3
2004,Indonesia-1,0,0,1,1
2004,Indonesia-2,0,0,0,0
2004,Iran,2,2,2,6
2004,Iraq,0,0,0,0
2004,Ireland,0,0,0,0
2004,Israel,1,0,1,2
2004,Italy,10,11,11,32
2004,Italy-1,0,0,0,0
2004,Italy-2,0,0,0,0
2004,Jamaica,2,1,2,5
2004,Japan,16,9,12,37
2004,Japan-1,0,0,0,0
2004,Japan-2,0,0,0,0
2004,Jordan,0,0,0,0
2004,Kazakhstan,1,4,3,8
2004,Kenya,1,4,2,7
2004,Kiribati,0,0,0,0
2004,Kuwait,0,0,0,0
2004,Kyrgyzstan,0,0,0,0
2004,Laos,0,0,0,0
2004,Latvia,0,4,0,4
2004,Lebanon,0,0,0,0
2004,Lesotho,0,0,0,0
2004,Liberia,0,0,0,0
2004,Libya,0,0,0,0
2004,Liechtenstein,0,0,0,0
2004,Lithuania,1,2,0,3
2004,Luxembourg,0,0,0,0
2004,Macedonia,0,0,0,0
2004,Madagascar,0,0,0,0
2004,Malawi,0,0,0,0
2004,Malaysia,0,0,0,0
2004,Malaysia-1,0,0,0,0
2004,Malaysia-2,0,0,0,0
2004,Maldives,0,0,0,0
2004,Mali,0,0,0,0
2004,Malta,0,0,0,0
2004,Mauritania,0,0,0,0
2004,Mauritius,0,0,0,0
2004,Mexico,0,3,1,4
2004,Moldova,0,0,0,0
2004,Monaco,0,0,0,0
2004,Mongolia,0,0,1,1
2004,Morocco,2,1,0,3
2004,Mozambique,0,0,0,0
2004,Myanmar,0,0,0,0
2004,Namibia,0,0,0,0
2004,Nauru,0,0,0,0
2004,Nepal,0,0,0,0
2004,Netherlands,4,9,9,22
2004,Netherlands Antilles,0,0,0,0
2004,New Zealand,3,2,0,5
2004,Nicaragua,0,0,0,0
2004,Niger,0,0,0,0
2004,Nigeria,0,0,2,2
2004,Nigeria-1,0,0,0,0
2004,Nigeria-2,0,0,0,0
2004,North Korea,0,4,1,5
2004,Norway,5,0,1,6
2004,Norway-1,0,0,0,0
2004,Norway-2,0,0,0,0
2004,Oman,0,0,0,0
2004,Pakistan,0,0,0,0
2004,Palau,0,0,0,0
2004,Palestine,0,0,0,0
2004,Panama,0,0,0,0
2004,Papua New Guinea,0,0,0,0
2004,Paraguay,0,1,0,1
2004,Peru,0,0,0,0
2004,Philippines,0,0,0,0
2004,Poland,3,2,5,10
2004,Portugal,0,2,1,3
2004,Puerto Rico,0,0,0,0
2004,Qatar,0,0,0,0
2004,Romania,8,5,6,19
2004,Russia,28,26,36,90
2004,Russia-1,0,0,0,0
2004,Russia-2,0,0,0,0
2004,Rwanda,0,0,0,0
2004,Saint Kitts and Nevis,0,0,0,0
2004,Saint Lucia,0,0,0,0
2004,Saint Vincent and the Grenadines,0,0,0,0
2004,Samoa,0,0,0,0
2004,San Marino,0,0,0,0
2004,Sao Tome and Principe,0,0,0,0
2004,Saudi Arabia,0,0,0,0
2004,Senegal,0,0,0,0
2004,Serbia and Montenegro,0,2,0,2
2004,Seychelles,0,0,0,0
2004,Sierra Leone,0,0,0,0
2004,Singapore,0,0,0,0
2004,Singapore-1,0,0,0,0
2004,Singapore-2,0,0,0,0
2004,Slovakia,2,2,2,6
2004,Slovakia-1,0,0,0,0
2004,Slovakia-2,0,0,0,0
2004,Slovenia,0,1,3,4
2004,Slovenia-1,0,0,0,0
2004,Slovenia-2,0,0,0,0
2004,Solomon Islands,0,0,0,0
2004,Somalia,0,0,0,0
2004,South Africa,1,3,2,6
2004,South Korea,8,11,8,27
2004,South Korea-1,0,1,1,2
2004,South Korea-2,1,0,0,1
2004,Spain,3,10,6,19
2004,Spain-1,0,0,0,0
2004,Spain-2,0,1,0,1
2004,Sri Lanka,0,0,0,0
2004,Sudan,0,0,0,0
2004,Suriname,0,0,0,0
2004,Swaziland,0,0,0,0
2004,Sweden,4,2,1,7
2004,Sweden-2,0,0,0,0
2004,Switzerland,1,1,2,4
2004,Switzerland-1,0,0,0,0
2004,Switzerland-2,0,0,1,1
2004,Syria,0,0,1,1
2004,Tajikistan,0,0,0,0
2004,Tanzania,0,0,0,0
2004,Thailand,3,1,4,8
2004,Thailand-1,0,0,0,0
2004,Thailand-2,0,0,0,0
2004,Timor Leste,0,0,0,0
2004,Togo,0,0,0,0
2004,Tonga,0,0,0,0
2004,Trinidad and Tobago,0,0,1,1
2004,Tunisia,0,0,0,0
2004,Turkey,3,3,5,11
2004,Turkmenistan,0,0,0,0
2004,Uganda,0,0,0,0
2004,Ukraine,8,5,9,22
2004,United Arab Emirates,1,0,0,1
2004,United States,35,39,25,99
2004,United States Virgin Islands,0,0,0,0
2004,United States-1,1,0,0,1
2004,United States-2,0,0,1,1
2004,Uruguay,0,0,0,0
2004,Uzbekistan,2,1,2,5
2004,Vanuatu,0,0,0,0
2004,Venezuela,0,0,2,2
2004,Vietnam,0,0,0,0
2004,Yemen,0,0,0,0
2004,Zambia,0,0,0,0
2004,Zimbabwe,1,1,1,3
2008,Afghanistan,0,0,1,1
2008,Albania,0,0,0,0
2008,Algeria,0,1,1,2
2008,American Samoa,0,0,0,0
2008,Andorra,0,0,0,0
2008,Angola,0,0,0,0
2008,Antigua and Barbuda,0,0,0,0
2008,Argentina,2,0,4,6
2008,Argentina-1,0,0,0,0
2008,Argentina-2,0,0,0,0
2008,Armenia,0,0,6,6
2008,Aruba,0,0,0,0
2008,Australia,14,15,17,46
2008,Australia-1,0,0,0,0
2008,Australia-2,0,0,0,0
2008,Austria,0,1,2,3
2008,Austria-1,0,0,0,0
2008,Austria-2,0,0,0,0
2008,Azerbaijan,1,2,4,7
2008,Bahamas,0,1,1,2
2008,Bahrain,0,0,0,0
2008,Bangladesh,0,0,0,0
2008,Barbados,0,0,0,0
2008,Belarus,4,5,9,18
2008,Belarus-1,0,0,0,0
2008,Belarus-2,0,0,0,0
2008,Belgium,1,1,0,2
2008,Belize,0,0,0,0
2008,Benin,0,0,0,0
2008,Bermuda,0,0,0,0
2008,Bhutan,0,0,0,0
2008,Bolivia,0,0,0,0
2008,Bonaparte,1,0,0,1
2008,Bosnia and Herzegovina,0,0,0,0
2008,Botswana,0,0,0,0
2008,Brazil,3,3,8,14
2008,Brazil-1,0,1,0,1
2008,Brazil-2,0,0,1,1
2008,Brentina,0,0,0,0
2008,Briar,0,0,0,0
2008,British Virgin Islands,0,0,0,0
2008,Bulgaria,1,1,3,5
2008,Burkina Faso,0,0,0,0
2008,Burundi,0,0,0,0
2008,Calimucho,0,0,0,0
2008,Cambodia,0,0,0,0
2008,Cameroon,1,0,0,1
2008,Canada,3,9,7,19
2008,Cape Verde,0,0,0,0
2008,Cayman Islands,0,0,0,0
2008,Central African Republic,0,0,0,0
2008,Chad,0,0,0,0
2008,Chile,0,1,0,1
2008,China,50,19,24,93
2008,China-1,1,2,2,5
2008,China-2,0,0,2,2
2008,China-3,0,0,0,0
2008,Chinese Taipei,0,0,4,4
2008,Clearwater,0,0,1,1
2008,Colombia,0,1,1,2
2008,Comoros,0,0,0,0
2008,Congo (Brazzaville),0,0,0,0
2008,Congo (Kinshasa),0,0,0,0
2008,Cook Islands,0,0,0,0
2008,Costa Rica,0,0,0,0
2008,Cote d'Ivoire,0,0,0,0
2008,Croatia,0,2,3,5
2008,Cuba,2,11,11,24
2008,Cuba-1,0,0,0,0
2008,Cuba-2,0,0,0,0
2008,Cyprus,0,0,0,0
2008,Czech Republic,3,3,0,6
2008,Czech Republic-1,0,0,0,0
2008,Czech Republic-2,0,0,0,0
2008,Denmark,2,2,2,6
2008,Denmark-1,0,0,0,0
2008,Denmark-2,0,0,0,0
2008,Diabolo St Maurice,0,0,0,0
2008,Digby,0,0,1,1
2008,Djibouti,0,0,0,0
2008,Dominica,0,0,0,0
2008,Dominican Republic,1,1,0,2
2008,Don Schufro,0,0,1,1
2008,Dow Jones,0,0,0,0
2008,Ecuador,0,1,0,1
2008,Egypt,0,0,1,1
2008,El Salvador,0,0,0,0
2008,Elvis Va,1,0,0,1
2008,Equatorial Guinea,0,0,0,0
2008,Eritrea,0,0,0,0
2008,Estonia,1,1,0,2
2008,Ethiopia,4,1,2,7
2008,Federated States of Micronesia,0,0,0,0
2008,Fiji,0,0,0,0
2008,Finland,1,1,2,4
2008,Floresco,0,0,0,0
2008,France,7,16,18,41
2008,France-1,0,0,0,0
2008,France-2,0,0,0,0
2008,Gabon,0,0,0,0
2008,Galopin De La Font,0,0,0,0
2008,Gambia,0,0,0,0
2008,Georgia,3,0,3,6
2008,Germany,15,10,15,40
2008,Germany-1,0,0,0,0
2008,Germany-2,0,0,0,0
2008,Ghana,0,0,0,0
2008,Gran Gesto,0,0,0,0
2008,Great Britain,19,13,16,48
2008,Great Britain-1,0,0,0,0
2008,Great Britain-2,0,0,0,0
2008,Greece,0,2,2,4
2008,Greece-1,0,0,0,0
2008,Greece-2,0,0,0,0
2008,Greenoaks Dundee,0,0,0,0
2008,Grenada,0,0,0,0
2008,Guam,0,0,0,0
2008,Guatemala,0,0,0,0
2008,Guinea,0,0,0,0
2008,Guinea Bissau,0,0,0,0
2008,Guyana,0,0,0,0
2008,Haiti,0,0,0,0
2008,Honduras,0,0,0,0
2008,Hong Kong,0,0,0,0
2008,Hungary,3,5,2,10
2008,Iceland,0,1,0,1
2008,India,1,0,2,3
2008,Indonesia,0,0,3,3
2008,Indonesia-1,1,1,0,2
2008,Indonesia-2,0,0,0,0
2008,Iran,1,0,1,2
2008,Iraq,0,0,0,0
2008,Ireland,0,1,2,3
2008,Israel,0,0,1,1
2008,Italy,8,9,10,27
2008,Italy-1,0,0,0,0
2008,Italy-2,0,0,0,0
2008,Jamaica,5,2,2,9
2008,Japan,9,7,9,25
2008,Japan-1,0,0,0,0
2008,Japan-2,0,0,0,0
2008,Jordan,0,0,0,0
2008,Kazakhstan,2,4,7,13
2008,Kenya,6,4,5,15
2008,Kiribati,0,0,0,0
2008,Kuwait,0,0,0,0
2008,Kyrgyzstan,0,1,1,2
2008,Lancet,0,0,0,0
2008,Laos,0,0,0,0
2008,Latvia,1,1,1,3
2008,Lebanon,0,0,0,0
2008,Lesotho,0,0,0,0
2008,Liberia,0,0,0,0
2008,Libya,0,0,0,0
2008,Liechtenstein,0,0,0,0
2008,Lithuania,0,2,3,5
2008,Lucky Star,0,0,0,0
2008,Luxembourg,0,0,0,0
2008,Macedonia,0,0,0,0
2008,Madagascar,0,0,0,0
2008,Malawi,0,0,0,0
2008,Malaysia,0,1,0,1
2008,Malaysia-1,0,0,0,0
2008,Malaysia-2,0,0,0,0
2008,Maldives,0,0,0,0
2008,Mali,0,0,0,0
2008,Malta,0,0,0,0
2008,Marshall Islands,0,0,0,0
2008,Mauritania,0,0,0,0
2008,Mauritius,0,0,1,1
2008,Mexico,2,0,1,3
2008,Mistral Hojris,0,0,0,0
2008,Moldova,0,0,1,1
2008,Monaco,0,0,0,0
2008,Mongolia,2,2,0,4
2008,Montenegro,0,0,0,0
2008,Morocco,0,1,1,2
2008,Mozambique,0,0,0,0
2008,Myanmar,0,0,0,0
2008,Mythilus,0,0,0,0
2008,Nadine,0,1,0,1
2008,Namibia,0,0,0,0
2008,Nauru,0,0,0,0
2008,Nepal,0,0,0,0
2008,Netherlands,7,4,4,15
2008,Netherlands Antilles,0,0,0,0
2008,Netherlands-1,0,0,0,0
2008,Netherlands-2,0,0,0,0
2008,New Zealand,3,2,4,9
2008,Nicaragua,0,0,0,0
2008,Niger,0,0,0,0
2008,Nigeria,0,1,3,4
2008,North Korea,2,1,3,6
2008,Norway,3,5,1,9
2008,Norway-1,0,0,0,0
2008,Norway-2,0,0,0,0
2008,Notavel,0,0,0,0
2008,Oman,0,0,0,0
2008,Orion,0,0,0,0
2008,Oxalis,0,0,0,0
2008,Pakistan,0,0,0,0
2008,Palau,0,0,0,0
2008,Palestine,0,0,0,0
2008,Panama,1,0,0,1
2008,Papua New Guinea,0,0,0,0
2008,Paraguay,0,0,0,0
2008,Peru,0,0,0,0
2008,Philippines,0,0,0,0
2008,Poland,3,6,1,10
2008,Poland-1,0,0,0,0
2008,Poland-2,0,0,0,0
2008,Pop Art,0,0,0,0
2008,Portugal,1,1,0,2
2008,Puerto Rico,0,0,0,0
2008,Qatar,0,0,0,0
2008,Quando Quando,0,0,0,0
2008,Rambo,0,0,0,0
2008,Ravel,0,0,0,0
2008,Relampago,0,0,0,0
2008,Romania,4,1,3,8
2008,Russia,23,21,28,72
2008,Russia-1,0,0,0,0
2008,Russia-2,0,0,0,0
2008,Rwanda,0,0,0,0
2008,Saint Kitts and Nevis,0,0,0,0
2008,Saint Lucia,0,0,0,0
2008,Saint Vincent and the Grenadines,0,0,0,0
2008,Salinero,0,1,0,1
2008,Samoa,0,0,0,0
2008,San Marino,0,0,0,0
2008,Sao Tome and Principe,0,0,0,0
2008,Satchmo,1,0,0,1
2008,Saudi Arabia,0,0,0,0
2008,Senegal,0,0,0,0
2008,Serbia,0,1,2,3
2008,Seychelles,0,0,0,0
2008,Sierra Leone,0,0,0,0
2008,Singapore,0,1,0,1
2008,Slovakia,3,2,1,6
2008,Slovenia,1,2,2,5
2008,Solomon Islands,0,0,0,0
2008,Solos Carex,0,0,0,0
2008,Somalia,0,0,0,0
2008,South Africa,0,1,0,1
2008,South Korea,12,9,7,28
2008,South Korea-1,1,1,1,3
2008,South Korea-2,0,0,0,0
2008,Spain,5,9,3,17
2008,Spain-1,0,1,0,1
2008,Spain-2,0,0,0,0
2008,Sri Lanka,0,0,0,0
2008,Sudan,0,1,0,1
2008,Sunrise,0,1,0,1
2008,Suriname,0,0,0,0
2008,Swaziland,0,0,0,0
2008,Sweden,0,3,1,4
2008,Sweden-1,0,0,0,0
2008,Sweden-2,0,1,0,1
2008,Switzerland,2,1,4,7
2008,Switzerland-1,0,0,0,0
2008,Switzerland-2,0,0,0,0
2008,Syria,0,0,0,0
2008,Tajikistan,0,1,1,2
2008,Tanzania,0,0,0,0
2008,Thailand,2,2,0,4
2008,Timor Leste,0,0,0,0
2008,Togo,0,0,1,1
2008,Tonga,0,0,0,0
2008,Trinidad and Tobago,1,1,0,2
2008,Tunisia,1,0,0,1
2008,Turkey,1,3,3,7
2008,Turkmenistan,0,0,0,0
2008,Tuvalu,0,0,0,0
2008,Uganda,0,0,0,0
2008,Ukraine,7,5,15,27
2008,Ukraine-1,0,0,0,0
2008,Ukraine-2,0,0,0,0
2008,United Arab Emirates,0,0,0,0
2008,United States,33,39,34,106
2008,United States Virgin Islands,0,0,0,0
2008,United States-1,2,0,1,3
2008,United States-2,1,0,0,1
2008,Uruguay,0,0,0,0
2008,Uzbekistan,1,2,3,6
2008,Vanuatu,0,0,0,0
2008,Venezuela,0,0,1,1
2008,Vietnam,0,1,0,1
2008,Whisper,0,0,0,0
2008,Whitini Star,0,0,0,0
2008,Yemen,0,0,0,0
2008,Zambia,0,0,0,0
2008,Zimbabwe,1,3,0,4
2012,Afghanistan,0,0,1,1
2012,Albania,0,0,0,0
2012,Algeria,1,0,0,1
2012,American Samoa,0,0,0,0
2012,Andorra,0,0,0,0
2012,Angola,0,0,0,0
2012,Antigua and Barbuda,0,0,0,0
2012,Argentina,1,1,2,4
2012,Armenia,0,1,2,3
2012,Aruba,0,0,0,0
2012,Australia,7,16,12,35
2012,Australia-1,0,0,0,0
2012,Australia-2,0,0,0,0
2012,Austria,0,0,0,0
2012,Azerbaijan,2,2,6,10
2012,Bahamas,1,0,0,1
2012,Bahrain,0,0,1,1
2012,Bangladesh,0,0,0,0
2012,Barbados,0,0,0,0
2012,Belarus,2,5,5,12
2012,Belgium,0,1,2,3
2012,Belize,0,0,0,0
2012,Benin,0,0,0,0
2012,Bermuda,0,0,0,0
2012,Bhutan,0,0,0,0
2012,Bolivia,0,0,0,0
2012,Bosnia and Herzegovina,0,0,0,0
2012,Botswana,0,1,0,1
2012,Brazil,3,4,8,15
2012,Brazil-1,0,1,1,2
2012,Brazil-2,0,0,0,0
2012,British Virgin Islands,0,0,0,0
2012,Brunei,0,0,0,0
2012,Bulgaria,0,1,1,2
2012,Burkina Faso,0,0,0,0
2012,Burundi,0,0,0,0
2012,Cambodia,0,0,0,0
2012,Cameroon,0,0,0,0
2012,Canada,1,5,12,18
2012,Cape Verde,0,0,0,0
2012,Cayman Islands,0,0,0,0
2012,Central African Republic,0,0,0,0
2012,Chad,0,0,0,0
2012,Chile,0,0,0,0
2012,China,35,26,23,84
2012,China-1,3,0,0,3
2012,China-2,0,1,0,1
2012,Chinese Taipei,0,1,1,2
2012,Colombia,1,3,4,8
2012,Comoros,0,0,0,0
2012,Congo (Brazzaville),0,0,0,0
2012,Congo (Kinshasa),0,0,0,0
2012,Cook Islands,0,0,0,0
2012,Costa Rica,0,0,0,0
2012,Cote d'Ivoire,0,0,0,0
2012,Croatia,3,1,2,6
2012,Cuba,5,3,6,14
2012,Cyprus,0,1,0,1
2012,Czech Republic,4,2,3,9
2012,Czech Republic-1,0,1,0,1
2012,Czech Republic-2,0,0,0,0
2012,Denmark,2,4,2,8
2012,Denmark-1,0,0,1,1
2012,Denmark-2,0,0,0,0
2012,Djibouti,0,0,0,0
2012,Dominica,0,0,0,0
2012,Dominican Republic,1,1,0,2
2012,Ecuador,0,0,0,0
2012,Egypt,0,2,0,2
2012,El Salvador,0,0,0,0
2012,Equatorial Guinea,0,0,0,0
2012,Eritrea,0,0,0,0
2012,Estonia,0,1,1,2
2012,Ethiopia,3,1,3,7
2012,Federated States of Micronesia,0,0,0,0
2012,Fiji,0,0,0,0
2012,Finland,0,1,2,3
2012,France,11,10,12,33
2012,France-1,0,1,0,1
2012,France-2,0,0,1,1
2012,Gabon,0,1,0,1
2012,Gambia,0,0,0,0
2012,Georgia,1,3,3,7
2012,Germany,10,19,14,43
2012,Germany-1,1,0,0,1
2012,Germany-2,0,0,0,0
2012,Ghana,0,0,0,0
2012,Great Britain,28,16,19,63
2012,Great Britain-1,1,0,0,1
2012,Great Britain-2,0,1,0,1
2012,Greece,0,0,2,2
2012,Grenada,1,0,0,1
2012,Guam,0,0,0,0
2012,Guatemala,0,1,0,1
2012,Guinea,0,0,0,0
2012,Guinea Bissau,0,0,0,0
2012,Guyana,0,0,0,0
2012,Haiti,0,0,0,0
2012,Honduras,0,0,0,0
2012,Hong Kong,0,0,1,1
2012,Hungary,8,4,6,18
2012,Iceland,0,0,0,0
2012,India,0,2,4,6
2012,India-1,0,0,0,0
2012,India-2,0,0,0,0
2012,Individual Olympic Athletes,0,0,0,0
2012,Indonesia,0,1,1,2
2012,Iran,4,5,3,12
2012,Iraq,0,0,0,0
2012,Ireland,1,1,3,5
2012,Israel,0,0,0,0
2012,Italy,8,9,11,28
2012,Italy-1,0,0,0,0
2012,Italy-2,0,0,0,0
2012,Jamaica,4,4,4,12
2012,Japan,7,13,17,37
2012,Japan-1,0,1,0,1
2012,Japan-2,0,0,0,0
2012,Jordan,0,0,0,0
2012,Kazakhstan,7,1,5,13
2012,Kenya,2,4,5,11
2012,Kiribati,0,0,0,0
2012,Kuwait,0,0,1,1
2012,Kyrgyzstan,0,0,0,0
2012,Laos,0,0,0,0
2012,Latvia,1,0,0,1
2012,Latvia-1,0,0,1,1
2012,Latvia-2,0,0,0,0
2012,Lebanon,0,0,0,0
2012,Lesotho,0,0,0,0
2012,Liberia,0,0,0,0
2012,Libya,0,0,0,0
2012,Liechtenstein,0,0,0,0
2012,Lithuania,2,1,2,5
2012,Luxembourg,0,0,0,0
2012,Macedonia,0,0,0,0
2012,Madagascar,0,0,0,0
2012,Malawi,0,0,0,0
2012,Malaysia,0,1,1,2
2012,Maldives,0,0,0,0
2012,Mali,0,0,0,0
2012,Malta,0,0,0,0
2012,Marshall Islands,0,0,0,0
2012,Mauritania,0,0,0,0
2012,Mauritius,0,0,0,0
2012,Mexico,1,3,3,7
2012,Moldova,0,0,2,2
2012,Monaco,0,0,0,0
2012,Mongolia,0,2,3,5
2012,Montenegro,0,1,0,1
2012,Morocco,0,0,1,1
2012,Mozambique,0,0,0,0
2012,Myanmar,0,0,0,0
2012,Namibia,0,0,0,0
2012,Nauru,0,0,0,0
2012,Nepal,0,0,0,0
2012,Netherlands,6,6,8,20
2012,Netherlands-1,0,0,0,0
2012,Netherlands-2,0,0,0,0
2012,New Zealand,6,2,5,13
2012,Nicaragua,0,0,0,0
2012,Niger,0,0,0,0
2012,Nigeria,0,0,0,0
2012,North Korea,4,0,2,6
2012,Norway,2,1,1,4
2012,Oman,0,0,0,0
2012,Pakistan,0,0,0,0
2012,Palau,0,0,0,0
2012,Palestine,0,0,0,0
2012,Panama,0,0,0,0
2012,Papua New Guinea,0,0,0,0
2012,Paraguay,0,0,0,0
2012,Peru,0,0,0,0
2012,Philippines,0,0,0,0
2012,Poland,2,2,6,10
2012,Poland-1,0,0,0,0
2012,Poland-2,0,0,0,0
2012,Portugal,0,1,0,1
2012,Puerto Rico,0,1,1,2
2012,Qatar,0,0,2,2
2012,Romania,2,5,2,9
2012,Russia,24,26,31,81
2012,Russia-1,0,0,1,1
2012,Russia-2,0,0,0,0
2012,Rwanda,0,0,0,0
2012,Saint Kitts and Nevis,0,0,0,0
2012,Saint Lucia,0,0,0,0
2012,Saint Vincent and the Grenadines,0,0,0,0
2012,Samoa,0,0,0,0
2012,San Marino,0,0,0,0
2012,Sao Tome and Principe,0,0,0,0
2012,Saudi Arabia,0,0,1,1
2012,Senegal,0,0,0,0
2012,Serbia,1,1,2,4
2012,Serbia-1,0,0,0,0
2012,Serbia-2,0,0,0,0
2012,Seychelles,0,0,0,0
2012,Sierra Leone,0,0,0,0
2012,Singapore,0,0,2,2
2012,Slovakia,0,1,3,4
2012,Slovenia,1,1,2,4
2012,Solomon Islands,0,0,0,0
2012,Somalia,0,0,0,0
2012,South Africa,3,2,1,6
2012,South Korea,13,8,6,27
2012,South Korea-1,0,0,1,1
2012,South Korea-2,0,0,0,0
2012,Spain,3,10,4,17
2012,Spain-1,0,0,0,0
2012,Spain-2,0,0,0,0
2012,Sri Lanka,0,0,0,0
2012,Sudan,0,0,0,0
2012,Suriname,0,0,0,0
2012,Swaziland,0,0,0,0
2012,Sweden,1,4,3,8
2012,Switzerland,2,2,0,4
2012,Switzerland-1,0,0,0,0
2012,Switzerland-2,0,0,0,0
2012,Syria,0,0,0,0
2012,Tajikistan,0,0,1,1
2012,Tanzania,0,0,0,0
2012,Thailand,0,2,1,3
2012,Timor Leste,0,0,0,0
2012,Togo,0,0,0,0
2012,Tonga,0,0,0,0
2012,Trinidad and Tobago,1,1,2,4
2012,Tunisia,1,1,1,3
2012,Turkey,2,2,1,5
2012,Turkmenistan,0,0,0,0
2012,Tuvalu,0,0,0,0
2012,Uganda,1,0,0,1
2012,Ukraine,6,5,9,20
2012,United Arab Emirates,0,0,0,0
2012,United States,43,27,28,98
2012,United States Virgin Islands,0,0,0,0
2012,United States-1,3,0,1,4
2012,United States-2,0,1,0,1
2012,Uruguay,0,0,0,0
2012,Uzbekistan,1,0,2,3
2012,Vanuatu,0,0,0,0
2012,Venezuela,1,0,0,1
2012,Vietnam,0,0,0,0
2012,Yemen,0,0,0,0
2012,Zambia,0,0,0,0
2012,Zimbabwe,0,0,0,0
2016,Afghanistan,0,0,0,0
2016,Albania,0,0,0,0
2016,Algeria,0,2,0,2
2016,American Samoa,0,0,0,0
2016,Andorra,0,0,0,0
2016,Angola,0,0,0,0
2016,Antigua and Barbuda,0,0,0,0
2016,Argentina,3,1,0,4
2016,Argentina-1,0,0,0,0
2016,Argentina-2,0,0,0,0
2016,Armenia,1,3,0,4
2016,Aruba,0,0,0,0
2016,Australia,8,11,10,29
2016,Australia-1,0,0,0,0
2016,Australia-2,0,0,0,0
2016,Austria,0,0,1,1
2016,Austria-1,0,0,0,0
2016,Austria-2,0,0,0,0
2016,Azerbaijan,1,7,10,18
2016,Bahamas,1,0,1,2
2016,Bahrain,1,1,0,2
2016,Bangladesh,0,0,0,0
2016,Barbados,0,0,0,0
2016,Belarus,1,4,4,9
2016,Belgium,2,2,2,6
2016,Belize,0,0,0,0
2016,Benin,0,0,0,0
2016,Bermuda,0,0,0,0
2016,Bhutan,0,0,0,0
2016,Bolivia,0,0,0,0
2016,Bosnia and Herzegovina,0,0,0,0
2016,Botswana,0,0,0,0
2016,Brazil,6,5,6,17
2016,Brazil-1,1,1,0,2
2016,Brazil-2,0,0,0,0
2016,British Virgin Islands,0,0,0,0
2016,Brunei,0,0,0,0
2016,Bulgaria,0,1,2,3
2016,Burkina Faso,0,0,0,0
2016,Burundi,0,1,0,1
2016,Cambodia,0,0,0,0
2016,Cameroon,0,0,0,0
2016,Canada,4,3,15,22
2016,Canada-1,0,0,0,0
2016,Canada-2,0,0,0,0
2016,Cape Verde,0,0,0,0
2016,Cayman Islands,0,0,0,0
2016,Central African Republic,0,0,0,0
2016,Chad,0,0,0,0
2016,Chile,0,0,0,0
2016,China,25,18,25,68
2016,China-1,1,0,1,2
2016,China-2,0,0,0,0
2016,Chinese Taipei,1,0,2,3
2016,Colombia,3,2,3,8
2016,Comoros,0,0,0,0
2016,Congo (Brazzaville),0,0,0,0
2016,Congo (Kinshasa),0,0,0,0
2016,Cook Islands,0,0,0,0
2016,Costa Rica,0,0,0,0
2016,Cote d'Ivoire,1,0,1,2
2016,Croatia,5,3,2,10
2016,Cuba,5,2,4,11
2016,Cyprus,0,0,0,0
2016,Czech Republic,1,2,6,9
2016,Czech Republic-1,0,0,1,1
2016,Czech Republic-2,0,0,0,0
2016,Denmark,2,6,7,15
2016,Djibouti,0,0,0,0
2016,Dominica,0,0,0,0
2016,Dominican Republic,0,0,1,1
2016,Ecuador,0,0,0,0
2016,Egypt,0,0,3,3
2016,El Salvador,0,0,0,0
2016,Equatorial Guinea,0,0,0,0
2016,Eritrea,0,0,0,0
2016,Estonia,0,0,1,1
2016,Ethiopia,1,2,5,8
2016,Federated States of Micronesia,0,0,0,0
2016,Fiji,1,0,0,1
2016,Finland,0,0,1,1
2016,France,10,18,14,42
2016,France-1,0,0,0,0
2016,France-2,0,0,0,0
2016,Gabon,0,0,0,0
2016,Gambia,0,0,0,0
2016,Georgia,2,1,4,7
2016,Germany,16,10,15,41
2016,Germany-1,1,0,0,1
2016,Germany-2,0,0,0,0
2016,Ghana,0,0,0,0
2016,Great Britain,27,23,17,67
2016,Great Britain-1,0,0,0,0
2016,Great Britain-2,0,0,0,0
2016,Greece,3,1,2,6
2016,Grenada,0,1,0,1
2016,Guam,0,0,0,0
2016,Guatemala,0,0,0,0
2016,Guinea,0,0,0,0
2016,Guinea Bissau,0,0,0,0
2016,Guyana,0,0,0,0
2016,Haiti,0,0,0,0
2016,Honduras,0,0,0,0
2016,Hong Kong,0,0,0,0
2016,Hungary,8,3,4,15
2016,Iceland,0,0,0,0
2016,India,0,1,1,2
2016,Individual Olympic Athletes,1,0,1,2
2016,Indonesia,0,2,0,2
2016,Indonesia-1,1,0,0,1
2016,Indonesia-2,0,0,0,0
2016,Iran,3,1,4,8
2016,Iraq,0,0,0,0
2016,Ireland,0,2,0,2
2016,Israel,0,0,2,2
2016,Italy,8,11,8,27
2016,Italy-1,0,1,0,1
2016,Italy-2,0,0,0,0
2016,Jamaica,6,3,2,11
2016,Japan,12,8,21,41
2016,Jordan,1,0,0,1
2016,Kazakhstan,3,5,10,18
2016,Kenya,6,6,1,13
2016,Kiribati,0,0,0,0
2016,Kosovo,1,0,0,1
2016,Kyrgyzstan,0,0,0,0
2016,Laos,0,0,0,0
2016,Latvia,0,0,0,0
2016,Lebanon,0,0,0,0
2016,Lesotho,0,0,0,0
2016,Liberia,0,0,0,0
2016,Libya,0,0,0,0
2016,Liechtenstein,0,0,0,0
2016,Lithuania,0,1,3,4
2016,Luxembourg,0,0,0,0
2016,Macedonia,0,0,0,0
2016,Madagascar,0,0,0,0
2016,Malawi,0,0,0,0
2016,Malaysia,0,4,1,5
2016,Maldives,0,0,0,0
2016,Mali,0,0,0,0
2016,Malta,0,0,0,0
2016,Marshall Islands,0,0,0,0
2016,Mauritania,0,0,0,0
2016,Mauritius,0,0,0,0
2016,Mexico,0,3,2,5
2016,Moldova,0,0,0,0
2016,Monaco,0,0,0,0
2016,Mongolia,0,1,1,2
2016,Montenegro,0,0,0,0
2016,Morocco,0,0,1,1
2016,Mozambique,0,0,0,0
2016,Myanmar,0,0,0,0
2016,Namibia,0,0,0,0
2016,Nauru,0,0,0,0
2016,Nepal,0,0,0,0
2016,Netherlands,8,7,3,18
2016,Netherlands-1,0,0,1,1
2016,Netherlands-2,0,0,0,0
2016,New Zealand,4,9,5,18
2016,Nicaragua,0,0,0,0
2016,Niger,0,1,0,1
2016,Nigeria,0,0,1,1
2016,North Korea,2,3,2,7
2016,Norway,0,0,4,4
2016,Oman,0,0,0,0
2016,Pakistan,0,0,0,0
2016,Palau,0,0,0,0
2016,Palestine,0,0,0,0
2016,Panama,0,0,0,0
2016,Papua New Guinea,0,0,0,0
2016,Paraguay,0,0,0,0
2016,Peru,0,0,0,0
2016,Philippines,0,1,0,1
2016,Poland,2,3,6,11
2016,Poland-1,0,0,0,0
2016,Poland-2,0,0,0,0
2016,Portugal,0,0,1,1
2016,Puerto Rico,1,0,0,1
2016,Qatar,0,1,0,1
2016,Refugee Olympic Athletes,0,0,0,0
2016,Romania,1,1,2,4
2016,Romania-1,0,0,0,0
2016,Romania-2,0,0,0,0
2016,Russia,18,17,20,55
2016,Russia-1,0,0,0,0
2016,Russia-2,1,0,0,1
2016,Rwanda,0,0,0,0
2016,Saint Kitts and Nevis,0,0,0,0
2016,Saint Lucia,0,0,0,0
2016,Saint Vincent and the Grenadines,0,0,0,0
2016,Samoa,0,0,0,0
2016,San Marino,0,0,0,0
2016,Sao Tome and Principe,0,0,0,0
2016,Saudi Arabia,0,0,0,0
2016,Senegal,0,0,0,0
2016,Serbia,2,4,2,8
2016,Seychelles,0,0,0,0
2016,Sierra Leone,0,0,0,0
2016,Singapore,1,0,0,1
2016,Slovakia,2,2,0,4
2016,Slovenia,1,2,1,4
2016,Solomon Islands,0,0,0,0
2016,Somalia,0,0,0,0
2016,South Africa,2,6,2,10
2016,South Korea,9,3,8,20
2016,South Korea-1,0,0,1,1
2016,South Korea-2,0,0,0,0
2016,South Sudan,0,0,0,0
2016,Spain,6,4,6,16
2016,Spain-1,0,0,0,0
2016,Spain-2,1,0,0,1
2016,Sri Lanka,0,0,0,0
2016,Sudan,0,0,0,0
2016,Suriname,0,0,0,0
2016,Swaziland,0,0,0,0
2016,Sweden,2,6,3,11
2016,Switzerland,3,2,2,7
2016,Switzerland-1,0,0,0,0
2016,Switzerland-2,0,0,0,0
2016,Syria,0,0,0,0
2016,Tajikistan,1,0,0,1
2016,Tanzania,0,0,0,0
2016,Thailand,2,2,2,6
2016,Timor Leste,0,0,0,0
2016,Togo,0,0,0,0
2016,Tonga,0,0,0,0
2016,Trinidad and Tobago,0,0,1,1
2016,Tunisia,0,0,3,3
2016,Turkey,1,3,4,8
2016,Turkmenistan,0,0,0,0
2016,Tuvalu,0,0,0,0
2016,Uganda,0,0,0,0
2016,Ukraine,2,5,4,11
2016,Ukraine-1,0,0,0,0
2016,Ukraine-2,0,0,0,0
2016,United Arab Emirates,0,0,1,1
2016,United States,45,36,36,117
2016,United States Virgin Islands,0,0,0,0
2016,United States-1,0,1,1,2
2016,United States-2,1,0,1,2
2016,Uruguay,0,0,0,0
2016,Uzbekistan,4,2,7,13
2016,Vanuatu,0,0,0,0
2016,Venezuela,0,1,2,3
2016,Vietnam,1,1,0,2
2016,Yemen,0,0,0,0
2016,Zambia,0,0,0,0
2016,Zimbabwe,0,0,0,0
2020,Afghanistan,0,0,0,0
2020,Albania,0,0,0,0
2020,Algeria,0,0,0,0
2020,American Samoa,0,0,0,0
2020,Andorra,0,0,0,0
2020,Angola,0,0,0,0
2020,Antigua and Barbuda,0,0,0,0
2020,Argentina,0,1,1,2
2020,Armenia,0,2,2,4
2020,Aruba,0,0,0,0
2020,Australia,16,7,22,45
2020,Austria,1,1,5,7
2020,Azerbaijan,0,3,4,7
2020,Bahamas,2,0,0,2
2020,Bahrain,0,1,0,1
2020,Bangladesh,0,0,0,0
2020,Barbados,0,0,0,0
2020,Belarus,1,3,3,7
2020,Belgium,3,1,3,7
2020,Belize,0,0,0,0
2020,Benin,0,0,0,0
2020,Bermuda,1,0,0,1
2020,Bhutan,0,0,0,0
2020,Bolivia,0,0,0,0
2020,Bosnia and Herzegovina,0,0,0,0
2020,Botswana,0,0,1,1
2020,Brazil,7,6,8,21
2020,British Virgin Islands,0,0,0,0
2020,Brunei,0,0,0,0
2020,Bulgaria,3,1,2,6
2020,Burkina Faso,0,0,1,1
2020,Burundi,0,0,0,0
2020,Cambodia,0,0,0,0
2020,Cameroon,0,0,0,0
2020,Canada,7,6,11,24
2020,Cape Verde,0,0,0,0
2020,Cayman Islands,0,0,0,0
2020,Central African Republic,0,0,0,0
2020,Chad,0,0,0,0
2020,Chile,0,0,0,0
2020,China,37,30,18,85
2020,Chinese Taipei,2,4,6,12
2020,Colombia,0,4,1,5
2020,Comoros,0,0,0,0
2020,Cook Islands,0,0,0,0
2020,Costa Rica,0,0,0,0
2020,Croatia,3,3,2,8
2020,Cuba,7,3,5,15
2020,Cyprus,0,0,0,0
2020,Czech Republic,4,4,3,11
2020,Democratic Republic of the Congo,0,0,0,0
2020,Denmark,3,4,4,11
2020,Djibouti,0,0,0,0
2020,Dominica,0,0,0,0
2020,Dominican Republic,0,3,2,5
2020,East Timor,0,0,0,0
2020,Ecuador,2,1,0,3
2020,Egypt,1,1,4,6
2020,El Salvador,0,0,0,0
2020,Equatorial Guinea,0,0,0,0
2020,Eritrea,0,0,0,0
2020,Estonia,1,0,1,2
2020,Eswatini,0,0,0,0
2020,Ethiopia,1,1,2,4
2020,Federated States of Micronesia,0,0,0,0
2020,Fiji,1,0,1,2
2020,Finland,0,0,2,2
2020,France,9,12,11,32
2020,Gabon,0,0,0,0
2020,Georgia,2,5,1,8
2020,Germany,10,11,16,37
2020,Ghana,0,0,1,1
2020,Great Britain,22,21,22,65
2020,Greece,2,1,1,4
2020,Grenada,0,0,1,1
2020,Guam,0,0,0,0
2020,Guatemala,0,0,0,0
2020,Guinea,0,0,0,0
2020,Guinea-Bissau,0,0,0,0
2020,Guyana,0,0,0,0
2020,Haiti,0,0,0,0
2020,Honduras,0,0,0,0
2020,"Hong Kong, China",1,2,3,6
2020,Hungary,6,7,7,20
2020,Iceland,0,0,0,0
2020,India,1,2,4,7
2020,Indonesia,1,1,3,5
2020,Iran,3,2,2,7
2020,Iraq,0,0,0,0
2020,Ireland,2,0,2,4
2020,Israel,2,0,2,4
2020,Italy,10,10,20,40
2020,Ivory Coast,0,0,1,1
2020,Jamaica,4,1,4,9
2020,Japan,27,14,16,57
2020,Jordan,0,1,1,2
2020,Kazakhstan,0,0,8,8
2020,Kenya,4,4,2,10
2020,Kiribati,0,0,0,0
2020,Kosovo,2,0,0,2
2020,Kuwait,0,0,1,1
2020,Kyrgyzstan,0,2,1,3
2020,Laos,0,0,0,0
2020,Latvia,1,0,1,2
2020,Lebanon,0,0,0,0
2020,Lesotho,0,0,0,0
2020,Liberia,0,0,0,0
2020,Libya,0,0,0,0
2020,Liechtenstein,0,0,0,0
2020,Lithuania,0,1,0,1
2020,Luxembourg,0,0,0,0
2020,Madagascar,0,0,0,0
2020,Malawi,0,0,0,0
2020,Malaysia,0,1,1,2
2020,Maldives,0,0,0,0
2020,Mali,0,0,0,0
2020,Malta,0,0,0,0
2020,Marshall Islands,0,0,0,0
2020,Mauritania,0,0,0,0
2020,Mauritius,0,0,0,0
2020,Mexico,0,0,4,4
2020,Moldova,0,0,1,1
2020,Monaco,0,0,0,0
2020,Mongolia,0,1,3,4
2020,Montenegro,0,0,0,0
2020,Morocco,1,0,0,1
2020,Mozambique,0,0,0,0
2020,Myanmar,0,0,0,0
2020,Namibia,0,1,0,1
2020,Nauru,0,0,0,0
2020,Nepal,0,0,0,0
2020,Netherlands,10,12,14,36
2020,New Zealand,7,6,7,20
2020,Nicaragua,0,0,0,0
2020,Niger,0,0,0,0
2020,Nigeria,0,1,1,2
2020,North Macedonia,0,1,0,1
2020,Norway,4,2,2,8
2020,Oman,0,0,0,0
2020,Pakistan,0,0,0,0
2020,Palau,0,0,0,0
2020,Palestine,0,0,0,0
2020,Panama,0,0,0,0
2020,Papua New Guinea,0,0,0,0
2020,Paraguay,0,0,0,0
2020,Peru,0,0,0,0
2020,Philippines,1,2,1,4
2020,Poland,4,5,5,14
2020,Portugal,1,1,2,4
2020,Puerto Rico,1,0,0,1
2020,Qatar,2,0,1,3
2020,Refugee Olympic Team,0,0,0,0
2020,Republic of the Congo,0,0,0,0
2020,Romania,1,3,0,4
2020,Russia,20,25,23,68
2020,Rwanda,0,0,0,0
2020,Saint Kitts and Nevis,0,0,0,0
2020,Saint Lucia,0,0,0,0
2020,Saint Vincent and the Grenadines,0,0,0,0
2020,Samoa,0,0,0,0
2020,San Marino,0,1,2,3
2020,Saudi Arabia,0,1,0,1
2020,Senegal,0,0,0,0
2020,Serbia,3,1,5,9
2020,Seychelles,0,0,0,0
2020,Sierra Leone,0,0,0,0
2020,Singapore,0,0,0,0
2020,Slovakia,1,2,1,4
2020,Slovenia,3,1,1,5
2020,Solomon Islands,0,0,0,0
2020,Somalia,0,0,0,0
2020,South Africa,1,2,0,3
2020,South Korea,6,4,10,20
2020,South Sudan,0,0,0,0
2020,Spain,3,8,6,17
2020,Sri Lanka,0,0,0,0
2020,Sudan,0,0,0,0
2020,Suriname,0,0,0,0
2020,Sweden,3,6,0,9
2020,Switzerland,3,4,6,13
2020,Syria,0,0,1,1
2020,São Tomé and Príncipe,0,0,0,0
2020,Tajikistan,0,0,0,0
2020,Tanzania,0,0,0,0
2020,Thailand,1,0,1,2
2020,The Gambia,0,0,0,0
2020,Togo,0,0,0,0
2020,Tonga,0,0,0,0
2020,Trinidad and Tobago,0,0,0,0
2020,Tunisia,1,1,0,2
2020,Turkey,2,2,9,13
2020,Turkmenistan,0,1,0,1
2020,Tuvalu,0,0,0,0
2020,Uganda,2,1,1,4
2020,Ukraine,1,6,12,19
2020,United Arab Emirates,0,0,0,0
2020,United States,35,41,33,109
2020,Uruguay,0,0,0,0
2020,Uzbekistan,3,0,2,5
2020,Vanuatu,0,0,0,0
2020,Venezuela,1,3,0,4
2020,Vietnam,0,0,0,0
2020,Virgin Islands,0,0,0,0
2020,Yemen,0,0,0,0
2020,Zambia,0,0,0,0
2020,Zimbabwe,0,0,0,0
2024,AIN,1,3,1,5
2024,Afghanistan,0,0,0,0
2024,Albania,0,0,2,2
2024,Algeria,2,0,1,3
2024,American Samoa,0,0,0,0
2024,Andorra,0,0,0,0
2024,Angola,0,0,0,0
2024,Antigua and Barbuda,0,0,0,0
2024,Argentina,1,1,1,3
2024,Armenia,0,3,1,4
2024,Aruba,0,0,0,0
2024,Australia,18,18,16,52
2024,Austria,2,0,3,5
2024,Azerbaijan,2,2,3,7
2024,Bahamas,0,0,0,0
2024,Bahrain,2,1,1,4
2024,Bangladesh,0,0,0,0
2024,Barbados,0,0,0,0
2024,Belgium,3,1,5,9
2024,Belize,0,0,0,0
2024,Benin,0,0,0,0
2024,Bermuda,0,0,0,0
2024,Bhutan,0,0,0,0
2024,Bolivia,0,0,0,0
2024,Bosnia & Herzegovina,0,0,0,0
2024,Botswana,1,1,0,2
2024,Brazil,3,6,10,19
2024,Brunei Darussalam,0,0,0,0
2024,Bulgaria,3,1,3,7
2024,Burkina Faso,0,0,0,0
2024,Burundi,0,0,0,0
2024,Cabo Verde,0,0,1,1
2024,Cambodia,0,0,0,0
2024,Cameroon,0,0,0,0
2024,Canada,9,6,11,26
2024,Cayman Islands,0,0,0,0
2024,Centr Afric Re,0,0,0,0
2024,Chad,0,0,0,0
2024,Chile,1,1,0,2
2024,China,38,26,24,88
2024,Chinese Taipei,2,0,5,7
2024,Colombia,0,3,1,4
2024,Comoros,0,0,0,0
2024,Congo,0,0,0,0
2024,Cook Islands,0,0,0,0
2024,Costa Rica,0,0,0,0
2024,Croatia,2,2,3,7
2024,Cuba,2,1,6,9
2024,Cyprus,0,1,0,1
2024,Czechia,3,0,2,5
2024,Côte d'Ivoire,0,0,1,1
2024,DPR Korea,0,2,4,6
2024,DR Congo,0,0,0,0
2024,Denmark,2,2,5,9
2024,Djibouti,0,0,0,0
2024,Dominica,1,0,0,1
2024,Dominican Republic,1,0,2,3
2024,EOR,0,0,1,1
2024,Ecuador,1,2,2,5
2024,Egypt,1,1,1,3
2024,El Salvador,0,0,0,0
2024,Equatorial Guinea,0,0,0,0
2024,Eritrea,0,0,0,0
2024,Estonia,0,0,0,0
2024,Eswatini,0,0,0,0
2024,Ethiopia,1,3,0,4
2024,Fiji,0,1,0,1
2024,Finland,0,0,0,0
2024,France,13,22,22,57
2024,Gabon,0,0,0,0
2024,Gambia,0,0,0,0
2024,Georgia,3,3,1,7
2024,Germany,11,10,8,29
2024,Ghana,0,0,0,0
2024,Great Britain,13,22,28,63
2024,Greece,1,1,6,8
2024,Grenada,0,0,2,2
2024,Guam,0,0,0,0
2024,Guatemala,1,0,1,2
2024,Guinea,0,0,0,0
2024,Guinea-Bissau,0,0,0,0
2024,Guyana,0,0,0,0
2024,Haiti,0,0,0,0
2024,Honduras,0,0,0,0
2024,"Hong Kong, China",2,0,2,4
2024,Hungary,6,7,5,18
2024,IR Iran,3,6,3,12
2024,Iceland,0,0,0,0
2024,India,0,1,5,6
2024,Indonesia,2,0,1,3
2024,Iraq,0,0,0,0
2024,Ireland,3,0,2,5
2024,Israel,1,5,1,7
2024,Italy,12,11,13,36
2024,Jamaica,1,3,2,6
2024,Japan,20,12,13,45
2024,Jordan,0,1,0,1
2024,Kazakhstan,1,3,3,7
2024,Kenya,4,2,5,11
2024,Kiribati,0,0,0,0
2024,Korea,13,9,10,32
2024,Kosovo,0,1,1,2
2024,Kuwait,0,0,0,0
2024,Kyrgyzstan,0,2,4,6
2024,Lao PDR,0,0,0,0
2024,Latvia,0,0,0,0
2024,Lebanon,0,0,0,0
2024,Lesotho,0,0,0,0
2024,Liberia,0,0,0,0
2024,Libya,0,0,0,0
2024,Liechtenstein,0,0,0,0
2024,Lithuania,0,2,2,4
2024,Luxembourg,0,0,0,0
2024,Madagascar,0,0,0,0
2024,Malawi,0,0,0,0
2024,Malaysia,0,0,2,2
2024,Maldives,0,0,0,0
2024,Mali,0,0,0,0
2024,Malta,0,0,0,0
2024,Marshall Islands,0,0,0,0
2024,Mauritania,0,0,0,0
2024,Mauritius,0,0,0,0
2024,Mexico,0,3,2,5
2024,Micronesia,0,0,0,0
2024,Monaco,0,0,0,0
2024,Mongolia,0,1,0,1
2024,Montenegro,0,0,0,0
2024,Morocco,1,0,1,2
2024,Mozambique,0,0,0,0
2024,Myanmar,0,0,0,0
2024,Namibia,0,0,0,0
2024,Nauru,0,0,0,0
2024,Nepal,0,0,0,0
2024,Netherlands,14,7,12,33
2024,New Zealand,10,7,3,20
2024,Nicaragua,0,0,0,0
2024,Niger,0,0,0,0
2024,Nigeria,0,0,0,0
2024,North Macedonia,0,0,0,0
2024,Norway,4,1,3,8
2024,Oman,0,0,0,0
2024,Pakistan,1,0,0,1
2024,Palau,0,0,0,0
2024,Palestine,0,0,0,0
2024,Panama,0,1,0,1
2024,Papua New Guinea,0,0,0,0
2024,Paraguay,0,0,0,0
2024,Peru,0,0,1,1
2024,Philippines,2,0,2,4
2024,Poland,1,4,5,10
2024,Portugal,1,2,1,4
2024,Puerto Rico,0,0,2,2
2024,Qatar,0,0,1,1
2024,Republic of Moldova,0,1,3,4
2024,Romania,3,4,2,9
2024,Rwanda,0,0,0,0
2024,Saint Lucia,1,1,0,2
2024,Samoa,0,0,0,0
2024,San Marino,0,0,0,0
2024,Sao Tome & Principe,0,0,0,0
2024,Saudi Arabia,0,0,0,0
2024,Senegal,0,0,0,0
2024,Serbia,3,1,1,5
2024,Seychelles,0,0,0,0
2024,Sierra Leone,0,0,0,0
2024,Singapore,0,0,1,1
2024,Slovakia,0,0,1,1
2024,Slovenia,2,1,0,3
2024,Solomon Islands,0,0,0,0
2024,Somalia,0,0,0,0
2024,South Africa,1,3,2,6
2024,South Sudan,0,0,0,0
2024,Spain,5,4,9,18
2024,Sri Lanka,0,0,0,0
2024,St Kitts and Nevis,0,0,0,0
2024,StVincent&Grenadines,0,0,0,0
2024,Sudan,0,0,0,0
2024,Suriname,0,0,0,0
2024,Sweden,4,4,3,11
2024,Switzerland,1,2,4,7
2024,Syria,0,0,0,0
2024,Tajikistan,0,0,3,3
2024,Tanzania,0,0,0,0
2024,Thailand,1,3,2,6
2024,Timor-Leste,0,0,0,0
2024,Togo,0,0,0,0
2024,Tonga,0,0,0,0
2024,Trinidad and Tobago,0,0,0,0
2024,Tunisia,1,1,1,3
2024,Turkmenistan,0,0,0,0
2024,Tuvalu,0,0,0,0
2024,Türkiye,0,3,5,8
2024,UA Emirates,0,0,0,0
2024,Uganda,1,1,0,2
2024,Ukraine,3,5,4,12
2024,United States,37,42,39,118
2024,Uruguay,0,0,0,0
2024,Uzbekistan,8,2,3,13
2024,Vanuatu,0,0,0,0
2024,Venezuela,0,0,0,0
2024,Vietnam,0,0,0,0
2024,"Virgin Islands, B",0,0,0,0
2024,"Virgin Islands, US",0,0,0,0
2024,Yemen,0,0,0,0
2024,Zambia,0,0,1,1
2024,Zimbabwe,0,0,0,0
